Stations_id,lat,long,crop,avg.sowing.doy,values_sowing,avg. harvest.doy,values_harvest,earliest.sowing.doy,latest.sowing.doy,earliest.harvest.doy,latest.harvest.doy
140,52.6861,11.4272,SB,93,51,218,29,68,119,205,234
164,53.0316,13.9908,SB,88,34,219,20,74,108,207,227
183,54.6792,13.4343,SB,96,38,224,28,78,116,213,241
198,51.3745,11.292,SB,76,64,220,35,36,100,199,234
222,50.5907,12.714,SB,97,40,228,27,73,113,214,241
591,53.3911,10.6878,SB,84,28,234,19,75,103,224,243
596,54.0028,11.1908,SB,92,39,225,35,70,109,213,248
640,50.8685,12.7237,SB,89,30,230,25,74,104,220,245
662,52.2915,10.4464,SB,85,38,213,24,68,106,201,225
717,51.3873,8.5737,SB,95,38,239,46,80,118,219,265
735,52.1692,12.7334,SB,84,38,221,20,64,102,211,231
822,51.2066,14.2371,SB,98,43,228,32,68,111,208,240
853,50.7913,12.872,SB,88,27,226,24,71,98,213,237
882,50.7813,10.786,SB,84,50,234,37,56,106,215,252
1133,52.1014,11.2322,SB,87,53,215,46,61,114,185,231
1246,51.8418,8.0607,SB,103,39,213,34,90,129,200,234
1412,50.8969,13.2205,SB,88,26,223,27,74,100,212,239
1532,53.6865,11.0608,SB,100,7,230,15,97,104,222,237
1612,50.8813,12.1289,SB,79,37,225,13,59,96,217,230
1684,51.1622,14.9506,SB,85,0,226,14,85,85,220,234
1691,51.5002,9.9507,SB,92,37,223,31,74,111,212,243
1757,54.0967,13.4056,SB,90,34,222,29,72,106,207,236
1780,50.4316,11.9443,SB,90,7,223,18,87,94,215,233
1820,50.85,11.6667,SB,79,42,224,40,55,97,204,244
2163,51.5448,10.8748,SB,80,50,236,22,54,104,223,245
2261,50.3122,11.8761,SB,96,33,222,34,75,108,203,237
2468,50.9352,12.6206,SB,80,44,221,21,54,98,211,232
2514,54.6667,9.9333,SB,104,19,225,18,95,114,218,236
2561,49.7167,8.1167,SB,82,28,217,21,68,96,206,227
2878,51.391,11.8788,SB,80,43,219,12,54,97,214,226
2925,51.3933,10.3123,SB,106,0,239,0,106,106,239,239
2932,51.4348,12.2396,SB,83,43,217,16,61,104,209,225
2995,52.8719,13.3927,SB,84,28,219,17,69,97,209,226
3015,52.2085,14.118,SB,73,0,217,0,73,73,217,217
3023,52.5181,7.3081,SB,98,30,219,22,87,117,211,233
3158,52.5468,14.5452,SB,105,0,224,0,105,105,224,224
3196,53.3223,11.9319,SB,90,9,220,2,86,95,219,221
3302,51.0418,11.0062,SB,76,54,212,24,40,94,200,224
3314,52.1458,11.9563,SB,86,36,213,32,75,111,198,230
3347,51.7384,9.7899,SB,87,37,224,27,70,107,211,238
3487,51.607,11.1183,SB,98,42,241,32,73,115,221,253
3491,50.441,11.2401,SB,100,0,237,0,100,100,237,237
3552,52.9037,12.8072,SB,94,0,209,23,94,94,202,225
3637,51.5158,10.7739,SB,92,30,223,38,78,108,201,239
3660,50.3601,6.8697,SB,78,10,219,14,75,85,212,226
3684,51.2873,11.0183,SB,64,31,224,26,50,81,205,231
3750,48.0579,9.9479,SB,90,0,231,0,90,90,231,231
3815,52.2553,8.0534,SB,92,48,217,32,71,119,201,233
4039,53.7331,9.8776,SB,97,52,222,72,67,119,186,258
4079,51.1765,11.4183,SB,84,40,221,24,56,96,206,230
4271,54.1803,12.0808,SB,86,0,229,10,86,86,224,234
4372,50.8063,10.2294,SB,86,25,224,28,74,99,210,238
4466,54.5275,9.5487,SB,89,31,221,30,75,106,204,234
4625,53.6425,11.3872,SB,90,21,221,41,81,102,204,245
4642,52.8911,11.7297,SB,80,18,206,29,71,89,188,217
4768,50.6574,9.9135,SB,106,11,231,13,101,112,223,236
4887,48.6657,9.8646,SB,88,39,224,30,70,109,210,240
4933,48.7091,9.2147,SB,84,30,214,31,68,98,198,229
4983,50.8619,11.2453,SB,84,17,220,30,73,90,206,236
5100,49.7479,6.6582,SB,90,33,219,17,74,107,210,227
5103,49.3544,7.7948,SB,92,15,235,8,83,98,231,239
5142,53.7444,14.0697,SB,88,27,222,10,74,101,215,225
5250,48.0908,7.6353,SB,77,23,195,24,66,89,185,209
5404,48.4025,11.6946,SB,83,29,213,24,69,98,203,227
5440,49.0116,10.9308,SB,85,26,218,18,71,97,211,229
5546,52.1207,12.4585,SB,79,28,212,29,69,97,201,230
5629,51.8892,12.6445,SB,88,41,213,14,64,105,205,219
5705,49.7703,9.9577,SB,84,29,220,8,70,99,216,224
5750,51.0314,12.1495,SB,85,34,215,27,64,98,207,234
7509,54.4333,9.7,SB,102,34,236,21,77,111,227,248
7513,54.6167,9.9833,SB,111,0,235,0,111,111,235,235
7516,54.4,9.9667,SB,96,37,231,30,76,113,216,246
7518,54.4,9.85,SB,105,9,218,19,102,111,207,226
7521,54.4333,9.8167,SB,96,1,226,15,96,97,217,232
7522,54.3667,10.0333,SB,103,10,228,0,97,107,228,228
7526,54.4333,10.05,SB,102,20,234,7,92,112,231,238
7528,54.55,9.8167,SB,96,8,228,13,93,101,222,235
7529,54.4833,10.1167,SB,116,15,246,13,107,122,239,252
7532,54.4,8.7667,SB,115,0,240,0,115,115,240,240
7536,54.0167,10.5667,SB,92,59,228,49,60,119,196,245
7544,54.1833,10.55,SB,96,36,230,25,78,114,221,246
7546,53.95,10.7333,SB,107,41,225,28,79,120,216,244
7554,54.7333,9.5667,SB,96,15,228,13,89,104,221,234
7555,54.7,9.55,SB,93,39,241,33,73,112,221,254
7557,54.6167,9.3667,SB,100,29,227,16,87,116,220,236
7559,54.75,9.9,SB,103,23,236,24,90,113,223,247
7563,54.7667,9.3167,SB,98,30,230,24,83,113,219,243
7565,54.7333,9.1,SB,102,20,223,31,88,108,212,243
7566,54.75,9.5167,SB,102,24,232,38,88,112,219,257
7568,54.7333,9.5,SB,109,13,244,20,102,115,230,250
7579,54.7667,9.1667,SB,89,35,222,26,75,110,207,233
7580,54.7167,9.6833,SB,103,26,246,0,89,115,246,246
7582,54.7333,9.7333,SB,114,0,227,12,114,114,222,234
7584,54.8,9.65,SB,107,5,240,27,104,109,228,255
7586,54.6833,9.3333,SB,89,21,220,48,76,97,195,243
7592,53.4833,10.6333,SB,106,24,223,32,95,119,211,243
7593,53.6833,10.5667,SB,99,23,240,19,87,110,231,250
7601,53.6167,10.7,SB,83,31,220,14,67,98,215,229
7605,53.75,10.6167,SB,106,14,229,25,101,115,214,239
7608,53.5,10.4833,SB,96,23,229,27,85,108,218,245
7610,53.45,10.55,SB,90,0,225,0,90,90,225,225
7616,54.6167,8.9667,SB,104,19,228,28,93,112,216,244
7620,54.4167,9.25,SB,107,27,230,11,91,118,225,236
7623,54.6667,9.1333,SB,99,46,220,42,74,120,204,246
7624,54.5167,8.65,SB,102,49,223,40,77,126,203,243
7635,54.25,9.1833,SB,100,19,224,27,90,109,212,239
7646,54.25,10.8333,SB,98,45,237,29,80,125,223,252
7650,54.1,10.8167,SB,96,41,234,19,70,111,228,247
7660,53.7,9.8,SB,100,20,227,32,88,108,214,246
7662,53.7333,9.7833,SB,89,9,222,29,86,95,205,234
7669,53.8167,9.7833,SB,99,31,225,45,85,116,206,251
7676,54.1167,10.4833,SB,103,25,226,3,86,111,224,227
7684,54.3567,10.182,SB,95,12,227,18,89,101,221,239
7686,54.3167,10.2167,SB,107,25,233,4,95,120,231,235
7693,54.2833,10.2333,SB,100,26,232,44,80,106,215,259
7696,54.1,10.2,SB,87,46,224,5,66,112,222,227
7700,54.1667,10.05,SB,94,23,229,0,83,106,229,229
7703,54.2,9.75,SB,106,26,228,9,98,124,224,233
7706,54.25,9.55,SB,104,19,225,29,92,111,215,244
7707,54.3,9.6,SB,99,9,229,23,94,103,217,240
7709,54.2333,9.5167,SB,96,24,216,16,83,107,211,227
7711,54.0833,9.65,SB,98,52,221,28,65,117,206,234
7712,54.3,9.5,SB,98,23,227,14,88,111,219,233
7713,54.2333,9.6667,SB,82,12,221,4,76,88,219,223
7714,54.05,9.7,SB,105,24,238,23,94,118,231,254
7715,54.1667,9.85,SB,97,18,223,33,89,107,208,241
7716,54.3,9.6667,SB,105,8,230,17,100,108,221,238
7717,54.3167,9.7,SB,102,11,249,0,97,108,249,249
7721,54.1167,9.4333,SB,98,32,228,28,88,120,211,239
7722,54.1333,9.55,SB,91,31,237,23,73,104,222,245
7725,54.2833,9.65,SB,90,17,224,7,78,95,220,227
7730,54.6167,9.8333,SB,109,36,228,50,89,125,200,250
7731,54.3167,9.3167,SB,108,16,236,0,100,116,236,236
7736,54.55,9.4,SB,94,12,215,28,89,101,205,233
7737,54.4167,9.5167,SB,99,27,224,38,85,112,208,246
7738,54.55,9.5167,SB,99,26,228,24,90,116,218,242
7743,54.35,9.2167,SB,110,0,228,0,110,110,228,228
7745,53.9167,9.8833,SB,104,26,226,15,91,117,219,234
7748,54.0667,10.2167,SB,98,2,228,0,97,99,228,228
7750,53.95,10.25,SB,100,21,243,27,87,108,232,259
7753,53.9667,10.0833,SB,100,4,226,10,98,102,222,232
7754,53.7833,10,SB,97,23,232,7,84,107,229,236
7755,53.85,9.9667,SB,101,13,228,34,94,107,211,245
7759,53.8167,10.15,SB,96,39,226,21,75,114,219,240
7761,54.0167,10.1667,SB,91,7,236,30,88,95,219,249
7765,54.0333,10.3167,SB,108,0,246,0,108,108,246,246
7769,53.7833,10.0833,SB,105,24,226,22,90,114,212,234
7772,53.9,9.7833,SB,103,15,223,27,96,111,210,237
7774,53.8167,9.6167,SB,101,24,225,17,90,114,216,233
7775,53.95,9.7167,SB,100,44,224,5,82,126,221,226
7778,54.0167,9.6833,SB,90,28,226,28,75,103,215,243
7779,53.9667,9.6167,SB,102,7,218,1,98,105,218,219
7781,54.0167,9.8,SB,95,31,221,43,75,106,202,245
7784,53.6667,10.2,SB,92,26,233,14,75,101,227,241
7786,53.7333,10.2667,SB,102,23,230,63,90,113,204,267
7790,53.7,10.0167,SB,96,12,220,14,90,102,215,229
7795,53.8333,10.4833,SB,105,10,229,3,100,110,228,231
7798,53.8667,10.3333,SB,104,25,227,18,90,115,218,236
7799,53.6167,10.4167,SB,104,27,227,43,91,118,198,241
7801,53.7333,10.1667,SB,99,16,228,29,91,107,217,246
7807,54.15,9.0667,SB,90,46,223,20,74,120,209,229
7811,54.0833,9.1167,SB,93,27,227,25,81,108,217,242
7812,53.9833,9.1167,SB,90,37,223,34,70,107,205,239
7815,53.9667,9.0833,SB,92,39,238,5,72,111,236,241
7817,54.7333,8.7333,SB,117,4,244,10,114,118,238,248
7818,54.8167,9.15,SB,115,10,241,0,110,120,241,241
7820,54.7833,8.95,SB,105,26,229,28,88,114,218,246
7821,54.8,9.1667,SB,92,29,231,22,74,103,221,243
7822,54.8667,8.7333,SB,117,18,246,3,107,125,245,248
7824,54.7333,8.4333,SB,82,7,216,10,79,86,211,221
7828,54.6833,8.5667,SB,103,5,228,15,101,106,219,234
7829,53.65,10.1833,SB,98,21,223,49,88,109,211,260
7830,53.4833,10.2333,SB,106,6,233,27,102,108,218,245
7844,53.6,10.1833,SB,83,0,196,0,83,83,196,196
7849,52.7,8.5,SB,87,26,212,27,77,103,201,228
7853,52.6333,8.3833,SB,89,21,220,33,81,102,199,232
7855,52.7667,8.75,SB,105,47,232,17,76,123,224,241
7857,52.6,8.8333,SB,84,31,217,23,66,97,203,226
7858,52.75,8.8333,SB,90,28,231,15,75,103,223,238
7859,52.6,8.4833,SB,97,28,228,6,78,106,225,231
7860,52.7333,8.6667,SB,88,5,220,6,85,90,217,223
7862,52.8,8.8333,SB,93,45,226,26,65,110,211,237
7863,52.6833,8.8,SB,87,25,221,27,74,99,208,235
7865,52.5667,8.5667,SB,99,21,217,20,87,108,209,229
7868,52.7833,9.1333,SB,85,31,224,34,69,100,212,246
7872,52.9,8.5833,SB,85,30,220,38,68,98,205,243
7875,52.8667,9.0333,SB,83,23,218,22,73,96,208,230
7876,52.9833,8.8167,SB,88,36,227,27,72,108,215,242
7877,52.8667,8.5,SB,99,7,229,0,96,103,229,229
7878,52.9,9.0333,SB,80,30,220,25,67,97,208,233
7879,52.9,8.8,SB,89,36,218,29,70,106,203,232
7881,52.85,9.1833,SB,92,39,223,36,76,115,203,239
7894,52.1333,9.5833,SB,93,36,230,28,72,108,219,247
7906,52.3,9.7333,SB,87,31,223,59,69,100,191,250
7912,52.3,9.8,SB,88,27,223,17,75,102,216,233
7918,52.4,9.6,SB,89,7,228,11,85,92,223,234
7919,52.55,9.4167,SB,95,23,222,22,85,108,212,234
7920,52.5333,9.4667,SB,84,29,214,29,71,100,199,228
7922,52.3833,9.35,SB,98,24,218,7,82,106,214,221
7923,52.4,9.45,SB,98,38,211,53,76,114,190,243
7925,52.5,9.45,SB,81,27,224,9,66,93,219,228
7927,52.5167,9.5167,SB,82,31,217,30,66,97,202,232
7931,52.5667,9.3,SB,90,26,220,26,74,100,211,237
7933,52.6667,9.25,SB,96,42,215,36,75,117,199,235
7936,52.5667,9.1333,SB,85,24,216,34,73,97,202,236
7937,52.6167,9.25,SB,93,24,220,16,85,109,211,227
7938,52.4167,8.75,SB,78,11,224,9,74,85,220,229
7939,52.6,9.0833,SB,88,23,216,21,75,98,205,226
7941,52.6667,9.1667,SB,88,17,218,38,78,95,200,238
7943,52.5,8.9833,SB,87,29,212,22,75,104,200,222
7944,52.65,9.2167,SB,100,0,228,0,100,100,228,228
7946,52.7167,9.25,SB,85,31,214,49,70,101,185,234
7948,52.6667,9.3833,SB,89,34,219,38,69,103,201,239
7950,52.45,8.85,SB,90,29,216,20,79,108,204,224
7951,52.4,9.1167,SB,101,23,228,24,88,111,216,240
7956,52.45,9.4,SB,91,0,210,12,91,91,204,216
7961,52.2167,9.15,SB,83,0,217,0,83,83,217,217
7963,52.2167,9.4,SB,96,35,229,21,78,113,217,238
7973,52.2167,9.55,SB,95,33,263,0,81,114,263,263
7974,52.2167,9.6333,SB,80,2,216,15,79,81,209,224
7978,52.15,9.95,SB,92,34,233,0,75,109,233,233
7979,52,9.9333,SB,87,23,225,35,75,98,208,243
7980,51.9833,9.8167,SB,91,39,215,41,72,111,192,233
7983,51.95,9.9167,SB,96,13,232,0,90,103,232,232
7984,52.0833,9.7833,SB,85,0,218,27,85,85,205,232
7987,51.9833,9.7833,SB,97,19,232,24,86,105,217,241
7990,51.5333,10.1833,SB,109,0,218,0,109,109,218,218
7992,51.5667,10.3167,SB,93,33,214,42,75,108,192,234
7994,51.5,10.1833,SB,101,20,220,19,87,107,210,229
7995,51.5667,10.2333,SB,104,12,231,10,100,112,229,239
7998,51.8,9.7,SB,84,27,219,3,74,101,218,221
8004,51.4333,9.9333,SB,92,32,221,26,75,107,206,232
8005,51.6167,10,SB,80,0,233,0,80,80,233,233
8007,51.55,10.0667,SB,84,42,216,33,66,108,198,231
8009,52.0333,10,SB,96,25,213,37,82,107,192,229
8010,52.0667,10.0167,SB,85,21,216,26,74,95,203,229
8015,51.95,10.1167,SB,106,0,235,10,106,106,230,240
8018,52.0833,10.15,SB,94,28,218,31,80,108,203,234
8020,52.2333,9.85,SB,108,24,219,32,94,118,204,236
8023,51.7,9.4333,SB,79,8,210,20,75,83,200,220
8025,51.9333,9.65,SB,88,59,223,3,62,121,221,224
8028,51.85,9.6333,SB,91,44,225,54,65,109,192,246
8036,51.3833,9.7667,SB,87,25,230,36,72,97,212,248
8037,51.4667,9.8,SB,96,31,233,37,78,109,220,257
8039,51.5167,9.7,SB,95,37,222,10,76,113,218,228
8045,51.6667,9.7833,SB,104,25,244,19,93,118,237,256
8046,51.7167,9.8333,SB,91,34,222,27,75,109,211,238
8048,51.7167,10,SB,96,28,227,21,79,107,215,236
8049,51.6833,9.55,SB,94,24,237,29,82,106,223,252
8052,51.6,10.45,SB,89,25,225,23,76,101,215,238
8053,51.7,10.1667,SB,93,21,225,21,85,106,216,237
8054,51.7667,10.1833,SB,90,21,217,0,80,101,217,217
8056,51.65,10.25,SB,89,29,224,31,75,104,209,240
8058,51.8,10.0333,SB,90,37,226,37,71,108,209,246
8060,51.7333,10.25,SB,90,32,235,11,74,106,229,240
8063,51.6,10.55,SB,99,44,236,22,71,115,221,243
8064,51.8167,10.0667,SB,88,38,225,20,70,108,214,234
8071,52.3167,10.2333,SB,80,29,213,25,65,94,196,221
8073,52.3,10.3167,SB,91,12,216,18,84,96,210,228
8084,52.6333,10.0833,SB,89,31,224,44,75,106,199,243
8087,52.5333,9.7667,SB,96,20,223,20,82,102,211,231
8088,52.45,10,SB,84,18,230,6,76,94,225,231
8090,52.5667,9.85,SB,89,18,220,21,77,95,211,232
8091,52.55,9.7667,SB,73,20,205,19,62,82,196,215
8093,52.4,10.0667,SB,88,24,223,12,78,102,216,228
8099,52.6,10.1167,SB,73,14,216,19,67,81,207,226
8100,52.6833,9.8167,SB,99,24,233,26,84,108,221,247
8101,52.8167,9.9667,SB,86,35,218,29,66,101,203,232
8104,52.7344,10.2244,SB,66,12,219,15,62,74,210,225
8105,52.7,10.2333,SB,80,30,218,31,65,95,205,236
8111,52.6167,10.15,SB,86,29,225,22,72,101,215,237
8113,52.7333,9.85,SB,84,26,212,18,70,96,200,218
8114,52.8667,10.1167,SB,89,21,223,20,78,99,213,233
8117,52.7333,10.1667,SB,82,30,220,20,66,96,212,232
8122,52.6667,9.8333,SB,91,26,217,23,80,106,205,228
8123,52.65,10.3833,SB,78,25,218,37,65,90,205,242
8125,52.7667,9.55,SB,82,47,223,35,55,102,209,244
8126,52.8,9.4833,SB,91,30,230,11,75,105,224,235
8127,52.9,9.6667,SB,86,28,222,37,69,97,206,243
8128,52.7667,9.4667,SB,87,34,218,30,70,104,204,234
8129,52.8333,9.6333,SB,86,40,219,35,69,109,199,234
8130,52.8667,9.7,SB,92,13,229,23,85,98,217,240
8132,52.9,9.5833,SB,92,22,225,24,80,102,212,236
8133,52.9333,9.7333,SB,95,24,226,34,83,107,213,247
8134,52.6667,9.6167,SB,87,22,221,35,76,98,203,238
8135,52.95,9.5333,SB,85,30,220,32,69,99,203,235
8137,52.8667,9.6,SB,74,44,217,22,52,96,206,228
8138,52.85,9.7333,SB,95,31,216,24,84,115,200,224
8144,52.4833,10.55,SB,83,27,215,24,70,97,205,229
8146,52.7333,10.6,SB,87,24,225,22,70,94,217,239
8147,52.3667,10.75,SB,98,32,225,33,86,118,210,243
8148,52.6833,10.7,SB,90,23,220,28,75,98,204,232
8149,52.3833,10.55,SB,97,30,240,4,80,110,238,242
8151,52.5333,10.35,SB,76,45,212,25,50,95,200,225
8153,52.3833,10.4833,SB,94,37,226,26,72,109,214,240
8157,52.6833,10.4,SB,86,36,218,35,65,101,199,234
8164,52.65,10.4333,SB,81,33,216,33,65,98,200,233
8165,52.6667,10.85,SB,91,32,217,24,72,104,206,230
8166,53.3333,9.8833,SB,92,23,224,46,83,106,210,256
8169,53.2333,10.1,SB,96,1,229,0,96,97,229,229
8171,53.25,10,SB,94,13,227,18,87,100,214,232
8172,53.3667,9.9833,SB,105,41,230,19,80,121,221,240
8174,53.3667,10.3,SB,101,25,228,29,91,116,214,243
8175,53.45,9.7333,SB,81,25,218,40,67,92,201,241
8178,53.2833,9.9167,SB,87,24,220,17,71,95,212,229
8182,53.4,9.8667,SB,100,7,219,19,97,104,209,228
8188,53.3333,10.1833,SB,102,21,229,18,90,111,220,238
8190,53.3,9.8,SB,87,26,220,14,74,100,214,228
8191,53.2667,10.1167,SB,88,17,221,25,79,96,208,233
8192,53.2833,9.7167,SB,102,0,223,22,102,102,216,238
8193,53.3167,9.8,SB,85,14,227,0,78,92,227,227
8197,53.2333,9.6667,SB,96,27,226,26,81,108,213,239
8203,53.0333,11.2667,SB,103,23,221,36,89,112,200,236
8212,53.0333,11.5333,SB,95,11,235,33,90,101,212,245
8213,53.0833,11.1833,SB,84,21,218,27,73,94,207,234
8227,53.1167,11.2,SB,86,49,211,28,65,114,200,228
8228,53,11.1513,SB,97,41,223,51,74,115,201,252
8232,53.05,11.2167,SB,93,30,222,25,78,108,208,233
8233,53.1,11.05,SB,89,16,214,43,83,99,189,232
8235,53.3667,10.4833,SB,97,15,228,27,90,105,216,243
8238,53.2,10.55,SB,85,28,220,21,68,96,209,230
8241,53.2833,10.3167,SB,90,31,224,15,69,100,218,233
8243,53.15,10.85,SB,92,42,224,15,79,121,218,233
8245,53.1333,10.2167,SB,83,26,219,26,69,95,208,234
8248,53.0833,10,SB,86,25,218,22,70,95,207,229
8251,53.0833,9.85,SB,87,20,222,22,76,96,210,232
8253,53.1167,9.8,SB,97,21,219,50,85,106,190,240
8255,53.1,10.0667,SB,88,27,222,28,75,102,211,239
8256,52.9333,10.15,SB,81,35,221,29,69,104,204,233
8258,52.9167,9.9667,SB,86,24,222,28,72,96,209,237
8259,53.1667,9.9667,SB,96,22,226,15,85,107,220,235
8260,53.0333,9.8333,SB,88,33,219,34,69,102,205,239
8261,53.1333,10.6,SB,84,34,222,35,66,100,203,238
8263,52.95,10.7667,SB,94,1,229,2,93,94,228,230
8266,52.9667,10.4667,SB,86,26,209,24,77,103,196,220
8268,52.95,10.8333,SB,89,30,218,21,70,100,205,226
8269,53.0333,10.4167,SB,87,32,222,27,65,97,209,236
8272,52.9167,10.4667,SB,81,21,216,37,70,91,195,232
8273,53.1,10.7333,SB,85,20,221,19,73,93,214,233
8279,52.8,10.6333,SB,81,22,210,20,67,89,199,219
8280,52.8333,10.7333,SB,89,36,213,35,70,106,193,228
8282,52.9,10.45,SB,82,6,218,2,79,85,217,219
8283,52.9167,10.7667,SB,89,0,218,13,89,89,211,224
8284,52.9833,10.7833,SB,84,24,221,44,68,92,192,236
8285,52.9667,10.5667,SB,84,26,217,42,69,95,194,236
8288,53.0833,10.2833,SB,83,42,216,24,60,102,202,226
8292,53.2667,9.2,SB,91,22,222,31,79,101,209,240
8293,53.4833,9.1333,SB,90,37,225,30,70,107,210,240
8294,53.25,9.3833,SB,89,21,220,20,76,97,214,234
8296,53.35,9.1833,SB,73,0,215,0,73,73,215,215
8300,53.3833,9.2167,SB,91,31,221,18,73,104,212,230
8301,53.45,9.1167,SB,90,35,213,15,71,106,205,220
8304,53.8167,8.7667,SB,99,32,236,37,83,115,218,255
8309,53.6333,9.1,SB,87,25,215,24,70,95,206,230
8317,53.75,8.8167,SB,94,15,225,29,86,101,214,243
8318,53.75,8.7833,SB,75,0,211,0,75,75,211,211
8319,53.6833,9.15,SB,97,23,220,33,83,106,199,232
8324,53.15,8.9333,SB,110,4,231,18,108,112,222,240
8326,53.2167,8.8,SB,102,24,224,49,89,113,204,253
8333,53.0667,9.3167,SB,82,29,216,33,67,96,202,235
8334,53.1333,9.5,SB,82,22,222,22,73,95,211,233
8336,53.1667,9.6667,SB,89,23,220,21,76,99,212,233
8337,53.0833,9.6,SB,86,29,219,40,69,98,198,238
8339,53.2,9.5333,SB,74,22,219,16,64,86,213,229
8340,53.0167,9.4833,SB,93,51,219,22,62,113,210,232
8342,53.1167,9.4167,SB,85,24,224,0,75,99,224,224
8348,53.5667,9.5167,SB,86,16,220,34,79,95,202,236
8350,53.4,9.5,SB,99,22,220,35,88,110,206,241
8352,53.6833,9.4333,SB,104,0,221,0,104,104,221,221
8353,53.6667,9.3833,SB,105,37,223,39,88,125,201,240
8354,53.45,9.3833,SB,81,23,218,27,72,95,206,233
8355,53.4667,9.7,SB,94,13,216,25,86,99,205,230
8360,53.5167,9.4833,SB,94,63,210,42,62,125,191,233
8361,53.6167,9.3167,SB,94,42,228,23,72,114,214,237
8362,53.4167,9.4667,SB,76,0,223,0,76,76,223,223
8363,53.7167,9.2833,SB,96,30,247,0,75,105,247,247
8365,53.4833,9.3333,SB,83,25,215,19,71,96,207,226
8368,53.8,9.25,SB,100,0,235,4,100,100,233,237
8370,53.3667,9.6,SB,94,20,222,40,81,101,202,242
8371,53.6,9.4833,SB,86,30,220,23,74,104,211,234
8373,53.0167,9.05,SB,82,19,220,23,73,92,211,234
8375,53.05,9.1833,SB,109,2,207,0,108,110,207,207
8376,52.8833,9.3167,SB,86,27,225,29,70,97,211,240
8380,52.9333,9.1833,SB,92,45,239,20,65,110,228,248
8381,52.9,9.2333,SB,93,22,211,21,82,104,198,219
8382,53.6283,8.8324,SB,95,32,221,28,76,108,209,237
8383,53.4333,8.8167,SB,100,39,227,26,75,114,216,242
8388,53.4333,8.6167,SB,107,40,216,12,79,119,212,224
8389,53.5333,8.8833,SB,92,24,204,0,80,104,204,204
8390,53.7167,8.7167,SB,94,1,204,0,94,95,204,204
8392,53.4167,8.5833,SB,104,0,212,15,104,104,204,219
8393,53.45,8.6167,SB,96,21,219,29,88,109,203,232
8397,53.65,8.5167,SB,74,0,232,10,74,74,227,237
8400,53.1,7.2167,SB,85,28,218,7,73,101,214,221
8402,52.9667,7.7667,SB,91,19,214,23,79,98,201,224
8403,53,7.3,SB,78,5,208,14,75,80,200,214
8404,52.8667,7.3167,SB,90,23,226,21,77,100,210,231
8407,52.85,7.6667,SB,93,18,219,7,85,103,215,222
8409,52.5333,7.8667,SB,87,13,216,27,80,93,201,228
8411,52.55,7.95,SB,91,54,220,20,55,109,211,231
8412,52.5833,7.7333,SB,86,30,220,20,68,98,209,229
8414,52.5167,7.6833,SB,89,19,217,16,79,98,208,224
8416,52.6667,7.95,SB,95,24,220,32,82,106,206,238
8418,52.4,7.85,SB,91,20,218,22,82,102,205,227
8420,52.4167,7.7333,SB,86,36,222,7,64,100,218,225
8422,52.5333,7.9333,SB,102,40,221,11,75,115,214,225
8424,52.6,6.85,SB,88,28,223,36,74,102,209,245
8425,52.6333,6.7667,SB,93,30,234,39,77,107,204,243
8426,52.3,7.1167,SB,95,19,214,26,84,103,202,228
8429,52.4333,7.0833,SB,106,4,219,0,104,108,219,219
8430,52.2833,7.2833,SB,94,24,220,32,83,107,202,234
8431,52.3167,7.2333,SB,95,23,218,22,81,104,210,232
8433,52.55,6.7333,SB,90,26,220,29,75,101,212,241
8434,52.5167,7.1333,SB,97,26,218,12,85,111,214,226
8438,52.6,7.4333,SB,96,23,219,21,87,110,209,230
8439,52.4833,7.55,SB,91,16,214,0,82,98,214,214
8440,52.5333,7.45,SB,73,29,217,27,62,91,203,230
8442,52.4,7.3,SB,93,25,218,11,80,105,213,224
8443,52.4833,7.4167,SB,85,12,213,0,81,93,213,213
8447,52.2,8.35,SB,95,27,235,33,81,108,216,249
8448,52.2,8.4667,SB,113,0,216,0,113,113,216,216
8452,52.7667,7.5,SB,86,28,220,20,71,99,210,230
8454,52.7833,7.2333,SB,75,56,217,21,52,108,203,224
8455,52.6667,7.4833,SB,81,29,218,12,66,95,211,223
8457,52.3,8.15,SB,96,14,231,0,90,104,231,231
8459,52.25,7.95,SB,95,33,219,36,75,108,199,235
8460,52.2,8.05,SB,104,11,217,4,98,109,215,219
8463,52.2333,7.9667,SB,101,31,228,22,81,112,211,233
8465,52.15,8.05,SB,82,31,227,10,68,99,222,232
8466,52.1,8.0833,SB,91,21,216,18,81,102,208,226
8467,52.3167,8.0333,SB,97,24,216,39,83,107,194,233
8468,52.2,8.0667,SB,100,17,223,21,93,110,212,233
8469,52.2333,8,SB,95,30,225,22,74,104,214,236
8471,52.0833,7.9333,SB,93,19,219,20,85,104,210,230
8473,52.25,8.1167,SB,91,25,220,35,78,103,200,235
8474,52.1167,8.05,SB,96,8,219,31,90,98,209,240
8475,52.2833,8.4167,SB,93,35,229,39,74,109,214,253
8477,52.3167,8.3667,SB,101,37,228,19,75,112,216,235
8478,52.3167,8.3333,SB,96,33,210,49,78,111,182,231
8482,53.35,7.1833,SB,104,32,242,22,83,115,231,253
8483,53.4667,7.4833,SB,96,25,240,2,83,108,239,241
8487,53.4667,7.4333,SB,106,7,238,26,103,110,225,251
8492,53.4,7.3333,SB,116,18,225,26,105,123,210,236
8495,53.4667,7.35,SB,103,0,215,0,103,103,215,215
8496,53.3833,7.5333,SB,101,12,239,2,97,109,238,240
8497,53.4667,7.5167,SB,86,29,226,15,72,101,220,235
8498,53.4167,7.7333,SB,108,16,227,18,99,115,220,238
8505,53.1667,7.45,SB,101,12,222,13,93,105,216,229
8506,53.2167,7.45,SB,99,25,243,6,83,108,239,245
8509,53.3,7.7167,SB,98,26,229,26,86,112,214,240
8517,53.4833,7.1833,SB,95,33,230,22,79,112,221,243
8520,53.6167,7.3,SB,109,45,236,0,90,135,236,236
8522,53.55,7.3,SB,103,35,236,36,88,123,216,252
8524,53.6,7.2167,SB,102,27,229,10,88,115,225,235
8527,53.5333,7.2833,SB,108,23,240,21,94,117,228,249
8529,53.6,7.15,SB,99,33,237,42,79,112,218,260
8530,53.35,7.1167,SB,96,33,241,42,77,110,228,270
8531,53.5333,7.7,SB,104,37,219,62,85,122,193,255
8534,53.6,7.6333,SB,109,16,222,4,104,120,220,224
8535,53.65,7.6167,SB,95,28,225,38,83,111,204,242
8539,53.7,7.7,SB,110,6,222,6,106,112,218,224
8542,53.6167,7.4667,SB,96,32,228,29,78,110,214,243
8545,53.5833,7.7667,SB,89,29,230,33,73,102,213,246
8546,52.3333,10.55,SB,95,0,214,6,95,95,211,217
8556,52.2833,10.7,SB,110,19,216,5,100,119,213,218
8557,52.2833,10.6167,SB,93,31,223,30,80,111,209,239
8558,52.9667,9.0167,SB,93,35,226,21,75,110,215,236
8561,51.9,9.85,SB,102,25,220,24,90,115,212,236
8562,51.9333,10.3667,SB,91,10,237,2,86,96,236,238
8569,51.8833,10.1667,SB,99,39,228,25,75,114,214,239
8570,51.7833,10.2167,SB,97,24,229,26,89,113,219,245
8573,51.9667,10.35,SB,88,27,214,32,71,98,198,230
8576,52.0167,10.4333,SB,79,0,236,16,79,79,228,244
8577,52.0167,10.4,SB,104,50,221,48,74,124,198,246
8579,51.95,10.5667,SB,90,33,213,38,72,105,194,232
8583,52.3167,11.0167,SB,102,24,236,10,90,114,231,241
8584,52.3667,10.9333,SB,92,26,227,0,79,105,227,227
8585,52.2333,11.0167,SB,75,32,219,6,60,92,216,222
8592,52.25,10.85,SB,85,23,225,22,72,95,214,236
8593,52.5,10.8833,SB,94,35,222,5,76,111,220,225
8594,52.2833,10.75,SB,89,41,213,30,65,106,197,227
8595,52.15,10.95,SB,96,43,217,35,75,118,200,235
8598,52.4333,10.85,SB,90,36,222,20,72,108,213,233
8599,52.1833,10.9333,SB,89,0,226,15,89,89,219,234
8600,52.1,10.85,SB,87,28,255,0,73,101,255,255
8605,51.8833,10.55,SB,108,21,223,30,95,116,204,234
8606,52.1833,10.7167,SB,96,34,221,22,79,113,210,232
8608,52.1667,10.5167,SB,88,36,212,47,73,109,194,241
8609,52.1333,10.7,SB,104,0,236,9,104,104,231,240
8611,52.1167,10.7167,SB,98,0,230,0,98,98,230,230
8615,53.05,8.6333,SB,90,0,215,0,90,90,215,215
8616,53.15,8.2,SB,86,24,220,38,75,99,203,241
8617,53.25,7.7667,SB,90,0,232,0,90,90,232,232
8618,53.1333,7.9833,SB,114,11,208,39,109,120,186,225
8621,53.25,8.2,SB,118,3,240,5,116,119,237,242
8623,53.2452,7.9053,SB,116,28,245,25,98,126,228,253
8626,53.25,8.1,SB,100,35,222,31,80,115,208,239
8629,53.1667,7.95,SB,107,8,227,23,102,110,217,240
8631,53.2,7.9833,SB,95,27,222,26,81,108,211,237
8635,53,7.95,SB,98,4,219,2,96,100,218,220
8636,52.8167,8.1167,SB,90,19,225,4,81,100,224,228
8639,52.7167,7.9333,SB,89,12,226,0,82,94,226,226
8640,53.0333,7.8667,SB,88,17,208,17,80,97,199,216
8641,52.9667,8.0167,SB,72,13,206,17,66,79,198,215
8644,52.7333,7.7667,SB,89,32,225,41,68,100,201,242
8647,53.0167,7.7667,SB,95,23,227,26,85,108,212,238
8652,53.6833,7.9333,SB,96,38,230,34,77,115,210,244
8653,53.5833,7.9,SB,87,44,230,9,69,113,226,235
8664,53.3833,8.05,SB,95,22,229,38,83,105,206,244
8665,53.3833,8.1,SB,104,23,218,41,96,119,198,239
8666,53.4167,7.9833,SB,95,37,221,23,74,111,209,232
8668,53.05,8.5333,SB,90,22,218,27,75,97,206,233
8670,53.1,8.5333,SB,97,34,220,11,80,114,213,224
8671,52.9833,8.2833,SB,90,13,225,0,81,94,225,225
8672,52.95,8.2167,SB,96,11,219,35,90,101,208,243
8673,53.05,8.2667,SB,85,24,222,14,72,96,215,229
8674,53.1167,8.45,SB,83,0,227,0,83,83,227,227
8675,53.0667,8.1667,SB,96,24,223,19,82,106,215,234
8676,52.9,8.4333,SB,95,29,209,14,76,105,202,216
8678,52.75,8.2,SB,97,25,227,20,84,109,217,237
8680,52.65,8.1167,SB,97,23,222,32,85,108,208,240
8683,52.6667,8.2333,SB,87,13,218,14,80,93,212,226
8685,52.7333,8.2833,SB,97,32,221,29,76,108,205,234
8706,53.0667,8.7667,SB,96,9,215,20,90,99,206,226
8710,53.1333,8.9167,SB,112,0,208,7,112,112,205,212
8723,51.3833,6.6,SB,81,28,206,21,67,95,196,217
8724,51.2,6.45,SB,81,26,223,36,68,94,209,245
8728,51.15,6.45,SB,102,0,205,40,102,102,185,225
8733,51.25,6.4,SB,78,29,218,31,63,92,201,232
8739,51.35,7.1167,SB,100,43,228,24,80,123,216,240
8752,51.15,6.6667,SB,86,7,201,0,82,89,201,201
8754,51.1,6.5,SB,93,35,205,14,78,113,196,210
8764,51.25,6.4833,SB,96,56,226,25,66,122,212,237
8765,51.3833,6.45,SB,82,25,222,30,71,96,205,235
8771,51.8,6.15,SB,86,11,230,1,81,92,229,230
8772,51.7,6.1667,SB,72,40,209,0,52,92,209,209
8775,51.75,6.3833,SB,93,29,220,20,74,103,210,230
8776,51.7833,6.0167,SB,84,29,200,24,72,101,192,216
8779,51.6667,6.2667,SB,79,42,228,0,52,94,228,228
8780,51.7833,6.45,SB,74,0,206,0,74,74,206,206
8782,51.6833,6.55,SB,97,13,225,20,92,105,215,235
8784,51.7333,6.5,SB,96,11,218,15,90,101,211,226
8790,51.0667,6.9333,SB,92,7,243,0,88,95,243,243
8804,51.5333,6.7,SB,88,31,220,30,71,102,206,236
8806,51.35,6.95,SB,99,38,225,42,80,118,201,243
8807,51.5167,6.3167,SB,92,33,214,44,74,107,200,244
8809,51.4833,6.4167,SB,84,25,218,31,73,98,201,232
8810,51.5167,6.4,SB,84,34,216,31,68,102,199,230
8811,51.4,6.3333,SB,89,8,211,0,85,93,211,211
8812,51.4,6.3,SB,90,16,220,14,79,95,213,227
8813,51.6333,6.1833,SB,92,33,212,34,72,105,195,229
8815,51.5833,6.25,SB,82,26,223,22,70,96,211,233
8816,51.5,6.5167,SB,102,3,214,42,101,104,188,230
8817,51.45,6.6333,SB,87,26,215,25,76,102,202,227
8818,51.55,6.6,SB,95,35,220,15,73,108,214,229
8819,51.6667,6.45,SB,94,35,235,0,76,111,235,235
8820,51.45,6.5833,SB,86,25,222,20,73,98,213,233
8822,51.5833,6.5333,SB,90,34,224,37,71,105,203,240
8823,51.6167,6.5333,SB,94,39,227,27,70,109,213,240
8824,51.65,6.6167,SB,89,32,224,37,73,105,208,245
8830,50.9167,6.9167,SB,69,20,208,33,61,81,191,224
8831,50.9833,6.9333,SB,82,15,211,0,77,92,211,211
8833,50.85,6.7667,SB,118,19,224,23,109,128,212,235
8842,50.6667,7.15,SB,95,36,233,33,79,115,217,250
8843,50.7,7.1667,SB,84,9,221,4,79,88,219,223
8849,50.6667,6.8,SB,93,41,220,26,74,115,203,229
8851,50.6833,6.6667,SB,82,43,219,39,59,102,199,238
8852,50.6167,6.65,SB,89,44,220,21,69,113,208,229
8854,50.6833,6.8167,SB,91,46,225,30,72,118,208,238
8869,50.8167,6.95,SB,88,33,215,20,73,106,205,225
8871,51.0333,7.5667,SB,100,35,238,21,81,116,224,245
8872,51.0333,7.6167,SB,104,32,229,29,88,120,217,246
8875,50.8667,7.6167,SB,91,31,234,14,75,106,228,242
8885,50.9167,7.5667,SB,68,0,204,0,68,68,204,204
8893,50.8833,7.0667,SB,96,27,200,35,78,105,187,222
8895,51.1167,7.4833,SB,97,32,230,26,83,115,219,245
8901,50.9333,7.3167,SB,93,38,227,28,77,115,212,240
8906,51.0667,7.3167,SB,104,28,239,41,90,118,217,258
8909,50.8,7.2,SB,96,21,226,22,84,105,213,235
8912,50.7667,7.45,SB,92,16,223,6,81,97,220,226
8914,50.7632,7.2631,SB,96,11,218,30,90,101,201,231
8915,50.7333,7.3,SB,98,26,212,0,85,111,212,212
8919,50.7167,7.3667,SB,85,0,235,0,85,85,235,235
8922,50.6667,7.3,SB,93,50,227,25,72,122,215,240
8923,50.6833,7.2667,SB,70,5,259,0,68,73,259,259
8925,50.7667,7.1667,SB,86,20,214,9,76,96,210,219
8932,50.8167,6.2667,SB,106,12,221,22,98,110,210,232
8934,50.7833,6.2,SB,103,8,210,49,100,108,187,236
8940,50.8,6.4167,SB,85,12,204,18,80,92,193,211
8941,50.7333,6.4833,SB,84,18,218,18,74,92,208,226
8946,50.7333,6.3833,SB,97,28,234,21,80,108,222,243
8947,50.7667,6.6333,SB,75,0,213,0,75,75,213,213
8951,51.0167,6.2833,SB,101,0,246,0,101,101,246,246
8958,50.8833,6.45,SB,90,9,218,17,85,94,209,226
8963,50.6,6.3167,SB,98,26,245,11,84,110,240,251
8971,50.4333,6.65,SB,94,45,229,22,69,114,218,240
8978,50.4167,6.4333,SB,110,27,220,0,96,123,220,220
8981,50.55,6.5833,SB,84,27,225,18,69,96,215,233
8983,50.3833,6.55,SB,104,46,228,21,73,119,217,238
8985,50.4833,6.6333,SB,97,39,236,28,75,114,217,245
8989,51.0667,6.1,SB,105,0,204,12,105,105,198,210
8990,50.9167,6.1167,SB,86,21,204,29,75,96,195,224
8994,51.0167,6.05,SB,93,26,218,38,82,108,195,233
8998,51.9667,7.6333,SB,100,1,220,3,100,101,218,221
9001,51.9968,6.9732,SB,95,19,216,9,82,101,211,220
9004,52.0333,7.1,SB,93,29,226,23,78,107,216,239
9005,52.1167,7.1167,SB,89,26,226,19,76,102,215,234
9012,51.7,7.8333,SB,99,43,220,54,82,125,186,240
9015,51.8042,8.2049,SB,87,37,220,31,68,105,208,239
9016,51.8167,7.95,SB,94,21,219,27,83,104,205,232
9018,51.7667,6.6167,SB,84,27,222,7,71,98,219,226
9020,51.8833,6.6667,SB,93,43,221,19,71,114,214,233
9023,51.9,6.7833,SB,92,27,216,46,76,103,186,232
9024,51.85,6.7,SB,92,21,223,23,81,102,213,236
9027,51.95,7.1833,SB,93,27,220,22,77,104,208,230
9028,51.9667,7.3,SB,102,50,225,16,82,132,218,234
9030,51.8333,7.3,SB,94,4,229,22,92,96,216,238
9031,51.85,7.2167,SB,96,0,218,0,96,96,218,218
9034,51.9833,7.15,SB,90,24,220,19,75,99,208,227
9035,51.7,7.75,SB,92,34,215,18,75,109,205,223
9042,51.7333,7.6667,SB,102,19,222,24,88,107,209,233
9050,51.9333,7.5333,SB,115,0,232,0,115,115,232,232
9052,51.9167,7.8167,SB,114,2,233,0,113,115,233,233
9054,52.1333,7.3833,SB,99,25,221,22,83,108,210,232
9055,52.15,7.3333,SB,94,22,224,23,82,104,210,233
9057,52.15,7.6,SB,82,17,208,3,75,92,206,209
9059,52.2333,7.3833,SB,88,11,220,17,82,93,210,227
9060,52.0833,7.4833,SB,90,24,215,37,78,102,195,232
9061,52.2,7.3167,SB,93,18,219,18,82,100,210,228
9065,52.1833,7.8667,SB,89,21,218,15,78,99,209,224
9067,52.1667,7.8833,SB,76,0,207,0,76,76,207,207
9071,52.3167,7.8,SB,91,41,223,9,70,111,219,228
9074,52.2667,7.7833,SB,92,15,214,9,85,100,209,218
9075,52.2833,7.7333,SB,96,16,225,13,87,103,219,232
9076,52.3333,7.5167,SB,93,46,223,12,76,122,218,230
9080,51.95,7.9833,SB,84,23,213,16,75,98,205,221
9083,51.8667,7.9167,SB,89,35,220,17,72,107,214,231
9084,51.9667,8.2333,SB,91,31,221,23,75,106,211,234
9087,51.5833,7.0667,SB,91,26,224,27,76,102,210,237
9088,51.6167,7.2,SB,91,35,223,20,69,104,216,236
9090,51.6,7.15,SB,97,0,212,0,97,97,212,212
9091,51.6,7.1,SB,94,11,213,12,89,100,207,219
9092,51.6,6.9167,SB,83,31,224,19,70,101,214,233
9096,51.7167,7.1,SB,86,27,214,21,73,100,204,225
9097,51.6667,6.95,SB,93,22,221,17,82,104,216,233
9100,51.6333,7.3833,SB,87,6,221,5,85,91,219,224
9109,52.0833,8.5167,SB,94,32,233,32,77,109,216,248
9111,51.6153,8.8972,SB,94,37,231,27,78,115,220,247
9112,51.6833,8.6,SB,87,23,209,25,79,102,198,223
9117,51.9462,8.8856,SB,91,12,211,45,86,98,193,238
9120,51.9167,8.75,SB,89,29,222,26,73,102,212,238
9131,52.05,8.3667,SB,95,41,204,38,72,113,186,224
9132,52.05,8.3,SB,93,39,255,0,72,111,255,255
9133,52,8.4167,SB,93,29,223,16,79,108,214,230
9134,52.0667,8.2,SB,96,36,215,36,78,114,193,229
9136,52.05,8.4333,SB,106,18,227,13,96,114,222,235
9144,51.7315,9.023,SB,102,22,230,24,89,111,214,238
9148,51.75,9.0667,SB,102,0,208,0,102,102,208,208
9155,51.8333,9.0667,SB,85,0,224,21,85,85,214,235
9156,51.85,9.2833,SB,90,30,224,19,76,106,217,236
9163,52.0333,9,SB,97,35,221,22,76,111,209,231
9166,52.1,8.9167,SB,96,36,233,27,75,111,219,246
9169,52.4167,8.6167,SB,89,45,221,31,69,114,209,240
9174,52.25,8.6667,SB,90,21,217,14,77,98,210,224
9177,52.3,8.5,SB,104,25,238,0,86,111,238,238
9178,52.4333,8.6167,SB,64,8,208,5,60,68,205,210
9187,52.25,8.7333,SB,94,32,220,24,76,108,209,233
9195,51.6667,8.8333,SB,86,19,220,12,75,94,214,226
9196,51.65,8.7333,SB,75,0,223,22,75,75,214,236
9198,51.7333,8.6833,SB,98,35,218,29,75,110,208,237
9199,51.7667,8.6667,SB,91,16,222,12,84,100,216,228
9200,51.7333,8.7167,SB,88,17,219,21,80,97,209,230
9202,51.5833,9.25,SB,87,0,225,0,87,87,225,225
9203,51.5833,9.3,SB,96,36,229,43,77,113,211,254
9209,51.6,9.1333,SB,94,27,224,16,78,105,216,232
9210,51.4667,9.1667,SB,92,35,225,26,73,108,213,239
9211,51.5333,9.0333,SB,108,1,241,7,107,108,237,244
9213,51.9167,8.3833,SB,91,25,220,24,76,101,210,234
9215,51.8833,8.2667,SB,90,20,212,22,80,100,203,225
