Stations_id,lat,long,crop,avg.sowing.doy,values_sowing,avg. harvest.doy,values_harvest,earliest.sowing.doy,latest.sowing.doy,earliest.harvest.doy,latest.harvest.doy
662,52.2915,10.4464,PO,98,37,189,18,81,118,179,197
1580,49.9859,7.9549,PO,101,0,187,0,101,101,187,187
1691,51.5002,9.9507,PO,107,0,185,23,107,107,174,197
2561,49.7167,8.1167,PO,103,0,184,8,103,103,181,189
3023,52.5181,7.3081,PO,108,26,187,21,92,118,180,201
3815,52.2553,8.0534,PO,97,50,191,37,72,122,172,209
4039,53.7331,9.8776,PO,95,41,193,21,75,116,182,203
4466,54.5275,9.5487,PO,101,27,187,21,86,113,174,195
5100,49.7479,6.6582,PO,115,16,202,17,107,123,195,212
5250,48.0908,7.6353,PO,104,0,173,0,104,104,173,173
5404,48.4025,11.6946,PO,106,19,191,40,95,114,160,200
5705,49.7703,9.9577,PO,107,11,194,9,100,111,189,198
7501,54.7833,9.4333,PO,114,0,200,2,114,114,199,201
7509,54.4333,9.7,PO,110,13,203,35,103,116,188,223
7516,54.4,9.9667,PO,107,24,191,25,92,116,178,203
7518,54.4,9.85,PO,105,0,208,14,105,105,201,215
7519,54.4167,9.8833,PO,125,9,218,0,121,130,218,218
7526,54.4333,10.05,PO,111,15,181,0,104,119,181,181
7528,54.55,9.8167,PO,114,20,186,13,106,126,179,192
7532,54.4,8.7667,PO,125,0,200,0,125,125,200,200
7536,54.0167,10.5667,PO,108,23,190,20,98,121,181,201
7537,54,10.4833,PO,110,0,197,0,110,110,197,197
7539,53.95,10.6833,PO,108,27,196,20,90,117,186,206
7540,54.1333,10.6167,PO,106,13,194,11,99,112,186,197
7543,54.2167,10.6167,PO,112,14,196,0,104,118,196,196
7544,54.1833,10.55,PO,109,29,193,24,91,120,180,204
7546,53.95,10.7333,PO,105,33,188,12,87,120,184,196
7554,54.7333,9.5667,PO,112,10,204,41,106,116,181,222
7555,54.7,9.55,PO,109,16,187,22,100,116,178,200
7559,54.75,9.9,PO,110,20,183,32,99,119,163,195
7566,54.75,9.5167,PO,109,30,180,1,94,124,180,181
7568,54.7333,9.5,PO,108,11,201,0,104,115,201,201
7575,54.6833,10,PO,116,16,213,11,108,124,208,219
7579,54.7667,9.1667,PO,95,13,185,50,91,104,160,210
7599,53.6833,10.6,PO,106,12,189,17,100,112,183,200
7601,53.6167,10.7,PO,88,15,192,8,79,94,187,195
7605,53.75,10.6167,PO,100,29,174,35,79,108,157,192
7616,54.6167,8.9667,PO,76,0,165,0,76,76,165,165
7620,54.4167,9.25,PO,110,28,186,8,90,118,182,190
7623,54.6667,9.1333,PO,106,28,192,46,90,118,166,212
7624,54.5167,8.65,PO,106,4,208,9,104,108,204,213
7635,54.25,9.1833,PO,98,15,167,30,91,106,152,182
7640,54.4333,11.2,PO,108,9,186,28,105,114,173,201
7641,54.5,11.1,PO,110,18,198,17,103,121,188,205
7642,54.2333,11.0833,PO,109,31,192,13,89,120,189,202
7643,54.25,10.9167,PO,119,11,193,17,111,122,184,201
7646,54.25,10.8333,PO,112,21,189,11,101,122,181,192
7650,54.1,10.8167,PO,112,16,196,0,104,120,196,196
7651,54.3,10.9,PO,110,17,184,4,103,120,182,186
7660,53.7,9.8,PO,104,20,179,13,92,112,172,185
7669,53.8167,9.7833,PO,106,15,189,23,100,115,178,201
7682,54.3167,10.5,PO,105,13,184,21,98,111,173,194
7684,54.3567,10.182,PO,99,20,180,26,87,107,166,192
7693,54.2833,10.2333,PO,115,11,199,31,110,121,178,209
7697,54.1167,10.1667,PO,112,15,184,30,104,119,170,200
7700,54.1667,10.05,PO,116,0,194,2,116,116,193,195
7701,54.3333,9.8333,PO,110,0,195,0,110,110,195,195
7703,54.2,9.75,PO,108,12,187,13,102,114,182,195
7706,54.25,9.55,PO,101,23,176,14,88,111,167,181
7709,54.2333,9.5167,PO,111,27,186,19,94,121,177,196
7711,54.0833,9.65,PO,106,31,193,21,95,126,184,205
7713,54.2333,9.6667,PO,112,0,186,0,112,112,186,186
7715,54.1667,9.85,PO,100,23,186,17,90,113,177,194
7716,54.3,9.6667,PO,110,13,191,16,105,118,185,201
7719,54.2667,9.9833,PO,107,0,196,7,107,107,193,200
7721,54.1167,9.4333,PO,112,20,198,18,100,120,188,206
7722,54.1333,9.55,PO,93,23,174,42,85,108,156,198
7730,54.6167,9.8333,PO,111,19,192,43,101,120,182,225
7737,54.4167,9.5167,PO,113,10,210,27,110,120,195,222
7745,53.9167,9.8833,PO,115,13,195,14,107,120,190,204
7746,53.9333,10.3,PO,96,17,197,0,88,105,197,197
7748,54.0667,10.2167,PO,111,32,197,41,94,126,183,224
7750,53.95,10.25,PO,104,13,203,44,99,112,183,227
7752,53.9,10.0667,PO,115,11,181,0,109,120,181,181
7753,53.9667,10.0833,PO,108,4,192,7,106,110,188,195
7754,53.7833,10,PO,99,10,180,9,95,105,175,184
7755,53.85,9.9667,PO,110,7,206,0,107,114,206,206
7757,53.9833,10.25,PO,103,11,210,21,97,108,199,220
7759,53.8167,10.15,PO,107,0,180,0,107,107,180,180
7761,54.0167,10.1667,PO,101,0,192,14,101,101,184,198
7769,53.7833,10.0833,PO,112,7,197,17,109,116,191,208
7772,53.9,9.7833,PO,106,13,174,16,101,114,167,183
7774,53.8167,9.6167,PO,99,14,185,20,90,104,174,194
7775,53.95,9.7167,PO,98,33,187,43,82,115,166,209
7776,53.85,9.4833,PO,105,18,184,59,92,110,163,222
7778,54.0167,9.6833,PO,102,16,181,32,92,108,164,196
7781,54.0167,9.8,PO,88,19,176,18,76,95,168,186
7784,53.6667,10.2,PO,114,12,202,16,107,119,196,212
7786,53.7333,10.2667,PO,100,18,174,21,89,107,166,187
7795,53.8333,10.4833,PO,107,33,184,15,83,116,175,190
7798,53.8667,10.3333,PO,108,36,192,12,79,115,188,200
7801,53.7333,10.1667,PO,108,11,177,23,102,113,168,191
7802,54.15,9.2833,PO,100,29,188,0,85,114,188,188
7805,54.0167,8.9,PO,99,23,195,32,88,111,177,209
7807,54.15,9.0667,PO,113,16,211,0,104,120,211,211
7811,54.0833,9.1167,PO,103,17,175,8,91,108,170,178
7812,53.9833,9.1167,PO,100,19,180,13,88,107,175,188
7819,54.75,8.9667,PO,109,9,195,17,105,114,187,204
7821,54.8,9.1667,PO,114,14,195,38,107,121,182,220
7828,54.6833,8.5667,PO,107,12,190,22,102,114,178,200
7829,53.65,10.1833,PO,106,35,188,46,81,116,157,203
7830,53.4833,10.2333,PO,109,3,185,15,107,110,179,194
7832,53.6667,10.0333,PO,117,20,201,0,107,127,201,201
7841,53.4333,10.2833,PO,101,4,189,6,99,103,186,192
7849,52.7,8.5,PO,108,0,191,0,108,108,191,191
7853,52.6333,8.3833,PO,103,6,158,0,100,106,158,158
7855,52.7667,8.75,PO,102,21,189,26,90,111,181,207
7858,52.75,8.8333,PO,101,9,182,31,96,105,173,204
7859,52.6,8.4833,PO,99,21,177,11,87,108,171,182
7862,52.8,8.8333,PO,108,31,199,23,95,126,189,212
7865,52.5667,8.5667,PO,108,12,204,15,102,114,197,212
7868,52.7833,9.1333,PO,93,34,168,17,70,104,158,175
7875,52.8667,9.0333,PO,99,25,162,22,88,113,146,168
7876,52.9833,8.8167,PO,96,13,182,11,88,101,175,186
7878,52.9,9.0333,PO,91,26,186,32,76,102,166,198
7879,52.9,8.8,PO,91,32,185,24,74,106,170,194
7881,52.85,9.1833,PO,106,21,181,3,93,114,179,182
7883,52.1667,9.25,PO,108,17,195,30,97,114,180,210
7892,52.1,9.4167,PO,106,0,205,0,106,106,205,205
7893,52.1167,9.55,PO,108,9,187,11,104,113,182,193
7894,52.1333,9.5833,PO,111,11,197,17,106,117,188,205
7897,52.0667,9.2667,PO,101,20,181,29,88,108,164,193
7902,52.0667,9.3667,PO,102,8,181,20,97,105,171,191
7912,52.3,9.8,PO,104,16,188,16,99,115,178,194
7918,52.4,9.6,PO,101,18,187,11,93,111,183,194
7919,52.55,9.4167,PO,95,15,177,5,86,101,175,180
7922,52.3833,9.35,PO,96,0,184,56,96,96,164,220
7923,52.4,9.45,PO,100,20,188,8,90,110,184,192
7925,52.5,9.45,PO,84,32,186,0,68,100,186,186
7927,52.5167,9.5167,PO,89,29,175,38,70,99,155,193
7930,52.7167,9.1333,PO,90,0,189,0,90,90,189,189
7931,52.5667,9.3,PO,97,11,181,10,91,102,178,188
7933,52.6667,9.25,PO,102,0,172,10,102,102,166,176
7937,52.6167,9.25,PO,98,21,175,17,90,111,167,184
7938,52.4167,8.75,PO,99,5,204,37,95,100,183,220
7943,52.5,8.9833,PO,99,20,218,0,87,107,218,218
7944,52.65,9.2167,PO,101,0,178,0,101,101,178,178
7946,52.7167,9.25,PO,94,18,178,14,86,104,171,185
7948,52.6667,9.3833,PO,91,31,184,12,73,104,176,188
7950,52.45,8.85,PO,98,16,180,13,90,106,173,186
7951,52.4,9.1167,PO,96,37,177,20,78,115,167,187
7952,52.2667,9.1,PO,101,40,181,37,87,127,164,201
7957,52.2333,9.1167,PO,110,16,197,35,102,118,180,215
7961,52.2167,9.15,PO,114,0,198,2,114,114,197,199
7962,52.4333,9.2667,PO,101,25,194,29,87,112,175,204
7963,52.2167,9.4,PO,107,10,187,16,101,111,179,195
7971,52.2667,9.7667,PO,109,8,196,27,105,113,184,211
7972,52.2667,9.35,PO,104,22,188,26,89,111,175,201
7973,52.2167,9.55,PO,108,7,196,16,106,113,192,208
7974,52.2167,9.6333,PO,101,20,181,15,88,108,171,186
7982,52.0667,9.7167,PO,105,9,204,13,101,110,196,209
7983,51.95,9.9167,PO,121,4,197,30,119,123,182,212
7984,52.0833,9.7833,PO,105,11,196,19,100,111,188,207
7986,52.1167,9.7,PO,109,0,195,8,109,109,190,198
7992,51.5667,10.3167,PO,102,17,196,28,92,109,183,211
7994,51.5,10.1833,PO,101,18,186,28,90,108,169,197
7995,51.5667,10.2333,PO,111,7,195,5,107,114,194,199
8004,51.4333,9.9333,PO,108,15,191,35,100,115,180,215
8007,51.55,10.0667,PO,117,9,208,8,111,120,204,212
8008,52.0167,10.1333,PO,112,7,190,15,109,116,183,198
8009,52.0333,10,PO,99,27,184,20,82,109,174,194
8010,52.0667,10.0167,PO,92,19,168,16,83,102,160,176
8015,51.95,10.1167,PO,110,19,195,39,99,118,173,212
8020,52.2333,9.85,PO,103,24,165,10,88,112,160,170
8025,51.9333,9.65,PO,95,48,194,10,69,117,190,200
8028,51.85,9.6333,PO,112,13,188,8,107,120,185,193
8032,51.9167,9.5167,PO,100,27,187,12,81,108,181,193
8034,51.35,9.6167,PO,113,0,204,3,113,113,202,205
8036,51.3833,9.7667,PO,102,13,176,8,94,107,172,180
8037,51.4667,9.8,PO,103,25,204,31,90,115,188,219
8046,51.7167,9.8333,PO,122,0,194,16,122,122,186,202
8048,51.7167,10,PO,99,14,202,0,92,106,202,202
8049,51.6833,9.55,PO,113,11,201,16,107,118,195,211
8052,51.6,10.45,PO,112,9,195,23,109,118,186,209
8053,51.7,10.1667,PO,100,26,188,28,88,114,178,206
8054,51.7667,10.1833,PO,98,9,185,0,94,103,185,185
8058,51.8,10.0333,PO,99,25,187,23,90,115,172,195
8060,51.7333,10.25,PO,104,23,182,0,90,113,182,182
8069,52.2333,10.2333,PO,104,5,181,22,101,106,167,189
8071,52.3167,10.2333,PO,84,36,185,48,68,104,152,200
8075,51.8167,10.35,PO,119,16,224,19,111,127,213,232
8087,52.5333,9.7667,PO,105,10,184,17,99,109,176,193
8091,52.55,9.7667,PO,73,0,181,0,73,73,181,181
8093,52.4,10.0667,PO,86,34,175,11,74,108,171,182
8100,52.6833,9.8167,PO,112,6,202,15,109,115,194,209
8101,52.8167,9.9667,PO,96,33,176,31,76,109,161,192
8104,52.7344,10.2244,PO,119,0,188,1,119,119,187,188
8105,52.7,10.2333,PO,100,20,189,24,88,108,178,202
8117,52.7333,10.1667,PO,103,40,203,31,76,116,185,216
8123,52.65,10.3833,PO,105,15,182,11,100,115,178,189
8125,52.7667,9.55,PO,94,43,182,44,65,108,156,200
8127,52.9,9.6667,PO,94,15,179,7,89,104,177,184
8128,52.7667,9.4667,PO,105,22,188,31,90,112,174,205
8132,52.9,9.5833,PO,114,13,191,31,108,121,182,213
8133,52.9333,9.7333,PO,114,17,201,15,107,124,194,209
8137,52.8667,9.6,PO,97,45,181,44,75,120,162,206
8144,52.4833,10.55,PO,93,22,181,16,83,105,171,187
8147,52.3667,10.75,PO,106,0,190,0,106,106,190,190
8149,52.3833,10.55,PO,110,18,204,34,104,122,186,220
8151,52.5333,10.35,PO,89,12,174,11,84,96,169,180
8153,52.3833,10.4833,PO,98,43,181,29,68,111,169,198
8157,52.6833,10.4,PO,102,31,204,35,84,115,183,218
8165,52.6667,10.85,PO,95,29,178,34,73,102,152,186
8166,53.3333,9.8833,PO,94,15,190,19,89,104,179,198
8169,53.2333,10.1,PO,96,0,165,0,96,96,165,165
8171,53.25,10,PO,105,19,191,10,93,112,186,196
8172,53.3667,9.9833,PO,104,11,189,0,99,110,189,189
8174,53.3667,10.3,PO,86,19,164,14,76,95,158,172
8175,53.45,9.7333,PO,96,16,207,0,90,106,207,207
8183,53.4167,10.3667,PO,97,28,163,19,80,108,153,172
8188,53.3333,10.1833,PO,106,10,180,17,100,110,172,189
8190,53.3,9.8,PO,107,15,192,6,100,115,189,195
8191,53.2667,10.1167,PO,93,25,172,22,79,104,164,186
8203,53.0333,11.2667,PO,96,32,178,19,80,112,168,187
8228,53,11.1513,PO,98,31,188,0,80,111,188,188
8233,53.1,11.05,PO,104,6,200,27,101,107,186,213
8235,53.3667,10.4833,PO,99,24,163,18,85,109,154,172
8238,53.2,10.55,PO,106,18,207,33,96,114,188,221
8241,53.2833,10.3167,PO,116,24,207,26,109,133,193,219
8248,53.0833,10,PO,106,0,178,0,106,106,178,178
8251,53.0833,9.85,PO,98,29,181,22,82,111,169,191
8253,53.1167,9.8,PO,105,15,215,27,95,110,198,225
8255,53.1,10.0667,PO,101,19,183,20,92,111,170,190
8256,52.9333,10.15,PO,101,17,195,33,91,108,179,212
8259,53.1667,9.9667,PO,104,9,211,10,100,109,206,216
8260,53.0333,9.8333,PO,97,15,190,28,90,105,178,206
8261,53.1333,10.6,PO,105,7,188,26,100,107,175,201
8263,52.95,10.7667,PO,94,0,204,2,94,94,203,205
8272,52.9167,10.4667,PO,96,26,182,28,80,106,171,199
8279,52.8,10.6333,PO,84,17,181,20,74,91,171,191
8283,52.9167,10.7667,PO,97,23,186,29,85,108,170,199
8284,52.9833,10.7833,PO,97,20,192,47,88,108,173,220
8285,52.9667,10.5667,PO,88,34,153,0,69,103,153,153
8288,53.0833,10.2833,PO,92,12,198,43,87,99,182,225
8292,53.2667,9.2,PO,104,27,183,45,88,115,156,201
8296,53.35,9.1833,PO,109,0,193,0,109,109,193,193
8300,53.3833,9.2167,PO,109,0,194,4,109,109,193,197
8301,53.45,9.1167,PO,103,21,196,30,93,114,182,212
8304,53.8167,8.7667,PO,104,39,192,34,76,115,180,214
8309,53.6333,9.1,PO,93,0,182,0,93,93,182,182
8317,53.75,8.8167,PO,110,7,185,19,106,113,176,195
8318,53.75,8.7833,PO,96,0,201,0,96,96,201,201
8320,53.2,8.6167,PO,111,21,206,0,100,121,206,206
8324,53.15,8.9333,PO,115,0,187,0,115,115,187,187
8326,53.2167,8.8,PO,109,19,201,27,98,117,192,219
8329,53.1833,8.8167,PO,104,23,182,24,89,112,174,198
8334,53.1333,9.5,PO,90,19,177,12,78,97,170,182
8336,53.1667,9.6667,PO,104,10,178,25,100,110,170,195
8342,53.1167,9.4167,PO,115,10,197,24,109,119,182,206
8348,53.5667,9.5167,PO,92,26,175,21,78,104,162,183
8350,53.4,9.5,PO,97,26,180,10,83,109,175,185
8352,53.6833,9.4333,PO,108,0,196,0,108,108,196,196
8353,53.6667,9.3833,PO,118,21,188,39,109,130,171,210
8354,53.45,9.3833,PO,91,19,196,37,79,98,176,213
8355,53.4667,9.7,PO,105,23,193,24,94,117,179,203
8361,53.6167,9.3167,PO,106,11,198,35,100,111,183,218
8362,53.4167,9.4667,PO,101,0,199,0,101,101,199,199
8363,53.7167,9.2833,PO,104,24,182,36,91,115,170,206
8365,53.4833,9.3333,PO,90,18,199,35,82,100,180,215
8368,53.8,9.25,PO,109,10,198,25,105,115,187,212
8370,53.3667,9.6,PO,104,43,207,18,80,123,198,216
8371,53.6,9.4833,PO,100,19,180,12,87,106,174,186
8373,53.0167,9.05,PO,89,16,178,16,80,96,171,187
8376,52.8833,9.3167,PO,100,20,175,14,89,109,167,181
8380,52.9333,9.1833,PO,95,31,187,22,75,106,178,200
8381,52.9,9.2333,PO,88,0,183,15,88,88,177,192
8382,53.6283,8.8324,PO,95,26,182,20,78,104,170,190
8383,53.4333,8.8167,PO,106,9,178,22,102,111,171,193
8388,53.4333,8.6167,PO,96,24,178,30,82,106,160,190
8389,53.5333,8.8833,PO,91,0,170,3,91,91,168,171
8390,53.7167,8.7167,PO,103,38,193,28,81,119,179,207
8392,53.4167,8.5833,PO,109,23,199,28,97,120,186,214
8393,53.45,8.6167,PO,97,0,167,11,97,97,161,172
8397,53.65,8.5167,PO,114,1,193,0,113,114,193,193
8399,52.3167,8.05,PO,104,15,186,25,96,111,174,199
8407,52.85,7.6667,PO,96,25,189,5,79,104,186,191
8409,52.5333,7.8667,PO,99,12,184,11,90,102,180,191
8411,52.55,7.95,PO,92,20,185,28,81,101,170,198
8412,52.5833,7.7333,PO,92,9,190,10,87,96,185,195
8414,52.5167,7.6833,PO,108,1,173,8,107,108,169,177
8416,52.6667,7.95,PO,100,28,185,10,85,113,181,191
8418,52.4,7.85,PO,105,0,189,2,105,105,188,190
8424,52.6,6.85,PO,105,18,178,4,97,115,176,180
8425,52.6333,6.7667,PO,100,17,180,54,89,106,163,217
8438,52.6,7.4333,PO,98,3,185,39,97,100,163,202
8439,52.4833,7.55,PO,88,0,178,0,88,88,178,178
8447,52.2,8.35,PO,104,0,199,0,104,104,199,199
8452,52.7667,7.5,PO,98,21,188,10,87,108,183,193
8455,52.6667,7.4833,PO,98,1,186,14,98,99,182,196
8456,52.7,7.3,PO,99,10,191,23,94,104,177,200
8459,52.25,7.95,PO,102,22,198,33,91,113,180,213
8460,52.2,8.05,PO,102,20,197,39,91,111,180,219
8463,52.2333,7.9667,PO,118,13,194,26,113,126,176,202
8466,52.1,8.0833,PO,112,12,190,30,108,120,175,205
8467,52.3167,8.0333,PO,99,14,216,20,90,104,205,225
8468,52.2,8.0667,PO,115,22,187,17,100,122,179,196
8469,52.2333,8,PO,110,3,213,0,108,111,213,213
8471,52.0833,7.9333,PO,107,17,176,39,99,116,151,190
8473,52.25,8.1167,PO,99,44,177,19,80,124,170,189
8474,52.1167,8.05,PO,112,6,206,0,109,115,206,206
8475,52.2833,8.4167,PO,112,13,197,17,105,118,189,206
8477,52.3167,8.3667,PO,103,19,188,26,94,113,180,206
8482,53.35,7.1833,PO,103,35,188,47,79,114,162,209
8483,53.4667,7.4833,PO,109,4,200,26,107,111,187,213
8487,53.4667,7.4333,PO,98,17,188,33,87,104,175,208
8492,53.4,7.3333,PO,103,13,198,19,95,108,187,206
8495,53.4667,7.35,PO,105,14,208,33,97,111,184,217
8496,53.3833,7.5333,PO,112,6,191,35,109,115,170,205
8497,53.4667,7.5167,PO,98,3,184,21,97,100,175,196
8498,53.4167,7.7333,PO,110,12,175,7,102,114,172,179
8499,53.5796,6.6664,PO,100,17,198,1,94,111,197,198
8505,53.1667,7.45,PO,95,12,186,14,87,99,179,193
8506,53.2167,7.45,PO,111,26,188,32,100,126,171,203
8511,53.2833,7.4333,PO,111,17,194,21,102,119,187,208
8518,53.45,7.0667,PO,102,16,180,31,92,108,167,198
8520,53.6167,7.3,PO,114,11,210,17,109,120,199,216
8522,53.55,7.3,PO,101,18,186,35,92,110,164,199
8527,53.5333,7.2833,PO,105,2,178,13,104,106,172,185
8529,53.6,7.15,PO,114,19,190,14,103,122,184,198
8530,53.35,7.1167,PO,100,20,193,49,85,105,176,225
8531,53.5333,7.7,PO,93,8,185,10,90,98,180,190
8532,53.6333,7.8167,PO,105,10,197,30,100,110,182,212
8534,53.6,7.6333,PO,105,10,179,36,100,110,161,197
8535,53.65,7.6167,PO,105,19,191,36,95,114,183,219
8539,53.7,7.7,PO,101,19,186,16,92,111,176,192
8542,53.6167,7.4667,PO,108,9,181,10,103,112,175,185
8545,53.5833,7.7667,PO,114,20,178,3,100,120,177,180
8557,52.2833,10.6167,PO,103,23,194,20,89,112,185,205
8558,52.9667,9.0167,PO,109,16,185,45,102,118,162,207
8559,52.2167,10.3667,PO,106,32,186,10,92,124,180,190
8565,51.95,10.2167,PO,111,17,190,27,103,120,177,204
8566,51.9833,10.2667,PO,103,0,190,0,103,103,190,190
8569,51.8833,10.1667,PO,104,10,169,6,100,110,166,172
8570,51.7833,10.2167,PO,110,13,193,23,103,116,179,202
8573,51.9667,10.35,PO,109,9,192,12,103,112,188,200
8576,52.0167,10.4333,PO,106,21,184,22,95,116,173,195
8577,52.0167,10.4,PO,109,36,198,21,87,123,184,205
8584,52.3667,10.9333,PO,108,20,201,29,98,118,188,217
8585,52.2333,11.0167,PO,96,23,191,0,85,108,191,191
8594,52.2833,10.75,PO,108,15,188,17,99,114,179,196
8595,52.15,10.95,PO,99,21,183,31,89,110,173,204
8598,52.4333,10.85,PO,88,18,176,15,78,96,170,185
8599,52.1833,10.9333,PO,116,20,183,15,106,126,174,189
8602,52.15,10.4667,PO,107,21,204,7,92,113,201,208
8605,51.8833,10.55,PO,111,7,194,3,108,115,193,196
8606,52.1833,10.7167,PO,102,40,188,25,78,118,175,200
8607,52.1,10.6333,PO,110,15,189,13,103,118,183,196
8608,52.1667,10.5167,PO,98,35,183,10,80,115,176,186
8609,52.1333,10.7,PO,92,44,178,18,65,109,170,188
8611,52.1167,10.7167,PO,107,30,197,41,88,118,172,213
8614,52.1667,10.55,PO,110,13,182,9,102,115,176,185
8616,53.15,8.2,PO,105,9,202,23,100,109,190,213
8621,53.25,8.2,PO,124,2,218,0,123,125,218,218
8631,53.2,7.9833,PO,113,9,184,30,108,117,172,202
8635,53,7.95,PO,74,5,178,1,72,77,178,179
8636,52.8167,8.1167,PO,106,34,194,34,88,122,178,212
8639,52.7167,7.9333,PO,102,14,208,18,94,108,199,217
8640,53.0333,7.8667,PO,104,6,184,12,101,107,178,190
8647,53.0167,7.7667,PO,102,38,200,26,81,119,183,209
8648,53.0833,7.6833,PO,101,0,178,0,101,101,178,178
8652,53.6833,7.9333,PO,106,30,194,10,90,120,190,200
8653,53.5833,7.9,PO,117,8,203,14,112,120,197,211
8660,53.5333,7.9333,PO,113,13,201,34,108,121,181,215
8664,53.3833,8.05,PO,102,21,175,35,88,109,156,191
8665,53.3833,8.1,PO,107,13,187,29,100,113,171,200
8668,53.05,8.5333,PO,105,19,173,22,94,113,166,188
8671,52.9833,8.2833,PO,97,0,178,0,97,97,178,178
8672,52.95,8.2167,PO,103,33,186,9,89,122,182,191
8673,53.05,8.2667,PO,102,29,190,43,87,116,166,209
8674,53.1167,8.45,PO,111,0,182,0,111,111,182,182
8675,53.0667,8.1667,PO,111,60,200,38,65,125,184,222
8676,52.9,8.4333,PO,104,8,174,2,99,107,173,175
8680,52.65,8.1167,PO,100,34,175,30,86,120,153,183
8683,52.6667,8.2333,PO,107,31,182,9,95,126,177,186
8685,52.7333,8.2833,PO,94,30,172,21,79,109,160,181
8689,53.1833,8.4833,PO,107,15,189,14,100,115,182,196
8701,53.35,8.4167,PO,110,15,183,27,100,115,173,200
8705,53.1,8.8667,PO,110,31,185,37,91,122,163,200
8710,53.1333,8.9167,PO,110,18,204,33,99,117,186,219
8724,51.2,6.45,PO,85,31,161,21,71,102,151,172
8728,51.15,6.45,PO,90,41,190,16,74,115,184,200
8729,51.2,7.0667,PO,114,12,193,2,108,120,192,194
8733,51.25,6.4,PO,72,4,172,30,70,74,161,191
8736,51.25,7.1167,PO,106,13,186,24,100,113,172,196
8739,51.35,7.1167,PO,108,24,180,0,100,124,180,180
8752,51.15,6.6667,PO,91,39,177,18,75,114,167,185
8754,51.1,6.5,PO,99,26,186,21,89,115,172,193
8756,51.3667,6.4167,PO,91,19,199,6,79,98,196,202
8761,51.3333,6.35,PO,84,25,169,5,71,96,166,171
8764,51.25,6.4833,PO,79,26,182,42,67,93,163,205
8765,51.3833,6.45,PO,85,30,165,12,71,101,160,172
8767,51.2333,6.55,PO,82,24,170,12,68,92,163,175
8770,51.3167,6.7167,PO,83,18,180,5,74,92,178,183
8771,51.8,6.15,PO,94,5,196,3,92,97,195,198
8772,51.7,6.1667,PO,54,0,176,14,54,54,169,183
8775,51.75,6.3833,PO,92,18,180,17,80,98,172,189
8779,51.6667,6.2667,PO,80,22,162,25,72,94,149,174
8780,51.7833,6.45,PO,74,0,171,0,74,74,171,171
8782,51.6833,6.55,PO,98,8,185,15,92,100,180,195
8784,51.7333,6.5,PO,92,3,173,9,90,93,169,178
8796,51.3667,6.7833,PO,96,7,181,4,93,100,179,183
8800,51.4167,6.9667,PO,92,4,192,21,90,94,182,203
8804,51.5333,6.7,PO,90,18,165,8,82,100,160,168
8806,51.35,6.95,PO,100,42,187,29,78,120,175,204
8807,51.5167,6.3167,PO,87,20,182,20,78,98,174,194
8809,51.4833,6.4167,PO,83,32,175,18,66,98,163,181
8810,51.5167,6.4,PO,88,47,170,16,67,114,163,179
8811,51.4,6.3333,PO,78,13,175,6,72,85,172,178
8812,51.4,6.3,PO,86,18,179,11,78,96,172,183
8813,51.6333,6.1833,PO,97,0,177,16,97,97,169,185
8815,51.5833,6.25,PO,95,38,183,21,82,120,178,199
8817,51.45,6.6333,PO,92,25,178,12,78,103,171,183
8818,51.55,6.6,PO,101,20,185,18,93,113,175,193
8819,51.6667,6.45,PO,98,22,192,28,87,109,176,204
8822,51.5833,6.5333,PO,82,37,173,29,64,101,158,187
8823,51.6167,6.5333,PO,83,37,174,37,64,101,158,195
8824,51.65,6.6167,PO,88,28,176,33,72,100,157,190
8831,50.9833,6.9333,PO,101,10,192,20,96,106,184,204
8833,50.85,6.7667,PO,86,23,179,7,75,98,176,183
8836,50.9667,6.75,PO,106,31,171,24,92,123,159,183
8842,50.6667,7.15,PO,98,33,201,24,82,115,189,213
8849,50.6667,6.8,PO,106,16,201,18,99,115,192,210
8851,50.6833,6.6667,PO,97,15,185,0,88,103,185,185
8856,50.7833,6.8167,PO,73,9,168,13,69,78,163,176
8863,50.9167,6.8167,PO,94,20,184,16,87,107,177,193
8869,50.8167,6.95,PO,82,20,170,9,72,92,166,175
8893,50.8833,7.0667,PO,98,22,195,19,89,111,183,202
8896,51.0167,7.3833,PO,122,0,188,23,122,122,177,200
8901,50.9333,7.3167,PO,99,15,180,0,89,104,180,180
8906,51.0667,7.3167,PO,105,17,212,11,98,115,205,216
8912,50.7667,7.45,PO,103,40,180,9,78,118,175,184
8915,50.7333,7.3,PO,96,17,185,22,88,105,171,193
8922,50.6667,7.3,PO,121,0,196,0,121,121,196,196
8928,50.7,7.2,PO,102,26,191,17,86,112,183,200
8932,50.8167,6.2667,PO,108,16,190,0,100,116,190,190
8933,50.8833,6.1,PO,102,0,204,0,102,102,204,204
8936,50.85,6.1667,PO,90,0,181,2,90,90,180,182
8940,50.8,6.4167,PO,105,31,189,17,90,121,180,197
8941,50.7333,6.4833,PO,104,21,193,37,92,113,181,218
8946,50.7333,6.3833,PO,111,7,196,7,108,115,193,200
8947,50.7667,6.6333,PO,101,18,180,17,91,109,176,193
8949,51.0667,6.1833,PO,95,20,184,40,85,105,166,206
8950,51.0333,6.3167,PO,109,5,200,0,107,112,200,200
8951,51.0167,6.2833,PO,79,21,177,31,70,91,160,191
8952,51.0833,6.4167,PO,102,45,177,14,78,123,171,185
8956,50.85,6.3667,PO,100,6,191,18,96,102,182,200
8958,50.8833,6.45,PO,84,19,177,10,73,92,173,183
8959,50.9333,6.4833,PO,85,27,180,0,72,99,180,180
8960,50.9667,6.4167,PO,88,24,174,18,74,98,166,184
8963,50.6,6.3167,PO,112,5,224,14,110,115,217,231
8981,50.55,6.5833,PO,101,30,193,21,83,113,181,202
8983,50.3833,6.55,PO,126,24,220,34,117,141,203,237
8985,50.4833,6.6333,PO,115,14,217,31,109,123,198,229
8989,51.0667,6.1,PO,95,10,185,0,90,100,185,185
8992,50.9833,6,PO,87,21,178,13,76,97,169,182
8994,51.0167,6.05,PO,85,15,171,19,77,92,160,179
8998,51.9667,7.6333,PO,90,1,172,5,90,91,170,175
9004,52.0333,7.1,PO,106,14,188,17,100,114,179,196
9012,51.7,7.8333,PO,100,30,187,9,83,113,183,192
9015,51.8042,8.2049,PO,103,30,199,29,89,119,187,216
9018,51.7667,6.6167,PO,98,21,194,29,87,108,178,207
9020,51.8833,6.6667,PO,94,23,177,15,79,102,171,186
9023,51.9,6.7833,PO,110,12,184,3,104,116,182,185
9024,51.85,6.7,PO,106,21,186,15,97,118,178,193
9028,51.9667,7.3,PO,115,18,208,18,107,125,199,217
9031,51.85,7.2167,PO,97,0,191,0,97,97,191,191
9034,51.9833,7.15,PO,105,4,180,5,103,107,177,182
9035,51.7,7.75,PO,107,26,202,2,92,118,201,203
9040,51.6667,7.4667,PO,107,8,208,21,104,112,199,220
9042,51.7333,7.6667,PO,99,24,178,0,88,112,178,178
9050,51.9333,7.5333,PO,104,7,175,14,101,108,169,183
9052,51.9167,7.8167,PO,102,19,183,7,94,113,179,186
9060,52.0833,7.4833,PO,102,13,178,6,96,109,176,182
9061,52.2,7.3167,PO,104,12,199,10,96,108,194,204
9065,52.1833,7.8667,PO,108,0,185,0,108,108,185,185
9067,52.1667,7.8833,PO,117,0,191,0,117,117,191,191
9071,52.3167,7.8,PO,118,8,185,24,114,122,176,200
9076,52.3333,7.5167,PO,104,24,179,19,92,116,170,189
9080,51.95,7.9833,PO,81,27,179,43,69,96,156,199
9082,51.9167,7.9667,PO,90,0,180,0,90,90,180,180
9083,51.8667,7.9167,PO,97,38,183,39,79,117,162,201
9084,51.9667,8.2333,PO,101,19,184,14,90,109,178,192
9088,51.6167,7.2,PO,106,21,204,11,92,113,199,210
9090,51.6,7.15,PO,76,0,178,5,76,76,176,181
9091,51.6,7.1,PO,98,10,184,10,94,104,179,189
9092,51.6,6.9167,PO,90,31,186,48,75,106,162,210
9097,51.6667,6.95,PO,105,20,204,12,92,112,198,210
9100,51.6333,7.3833,PO,95,10,185,7,89,99,183,190
9109,52.0833,8.5167,PO,95,21,181,27,85,106,170,197
9112,51.6833,8.6,PO,104,22,192,20,87,109,182,202
9113,51.6833,8.5667,PO,106,13,179,23,100,113,171,194
9117,51.9462,8.8856,PO,104,22,186,19,89,111,175,194
9121,51.9,9.1667,PO,111,14,200,19,101,115,191,210
9133,52,8.4167,PO,101,21,186,2,90,111,185,187
9136,52.05,8.4333,PO,106,22,208,15,96,118,200,215
9138,52.2,8.6,PO,98,22,196,19,85,107,184,203
9144,51.7315,9.023,PO,111,0,211,0,111,111,211,211
9147,51.7167,9.1833,PO,117,11,211,25,111,122,194,219
9155,51.8333,9.0667,PO,86,6,178,31,83,89,161,192
9156,51.85,9.2833,PO,108,19,194,41,99,118,174,215
9159,52.0833,8.75,PO,101,15,201,2,91,106,200,202
9161,51.9833,8.6667,PO,99,26,187,8,83,109,182,190
9166,52.1,8.9167,PO,105,24,182,15,90,114,175,190
9169,52.4167,8.6167,PO,94,34,199,38,75,109,184,222
9174,52.25,8.6667,PO,97,0,190,14,97,97,181,195
9178,52.4333,8.6167,PO,58,0,156,3,58,58,155,158
9180,52.3,8.9167,PO,99,12,193,30,92,104,183,213
9183,52.2333,9.0333,PO,108,31,189,26,92,123,175,201
9187,52.25,8.7333,PO,119,13,195,41,109,122,172,213
9196,51.65,8.7333,PO,105,0,201,0,105,105,201,201
9198,51.7333,8.6833,PO,97,33,177,29,75,108,162,191
9199,51.7667,8.6667,PO,97,10,186,11,91,101,180,191
9200,51.7333,8.7167,PO,101,4,184,22,100,104,172,194
9202,51.5833,9.25,PO,99,25,182,7,88,113,179,186
9203,51.5833,9.3,PO,110,11,197,15,103,114,189,204
9209,51.6,9.1333,PO,102,26,179,18,86,112,170,188
9215,51.8833,8.2667,PO,93,19,182,14,85,104,175,189
9219,51.85,8.5,PO,98,24,181,26,84,108,172,198
9220,51.9167,8.5667,PO,107,0,212,0,107,107,212,212
9235,51.4,8.0667,PO,112,13,188,15,105,118,182,197
9243,51.3,8.0333,PO,118,13,216,10,111,124,211,221
9247,51.45,8.35,PO,116,17,216,22,110,127,203,225
9249,51.3333,8.55,PO,107,24,198,17,96,120,191,208
9256,51.2,8.7,PO,119,16,222,35,113,129,198,233
9260,51.45,8.6167,PO,109,23,209,17,93,116,200,217
9269,51.6667,8.35,PO,97,22,177,25,85,107,165,190
9274,51.65,8.2333,PO,99,21,207,7,88,109,204,211
9275,51.6167,8.3333,PO,95,19,179,13,87,106,174,187
9278,51.35,8.3333,PO,99,6,192,12,97,103,188,200
9314,50.9,7.8667,PO,130,3,230,0,129,132,230,230
9315,50.9667,8.1,PO,106,31,229,20,89,120,218,238
9321,51.55,7.9167,PO,96,6,175,0,93,99,175,175
9326,51.5,8.05,PO,104,0,182,12,104,104,176,188
9329,51.65,8.1333,PO,101,11,191,10,96,107,188,198
9330,51.6333,8.1,PO,106,6,202,5,103,109,200,205
9356,51.65,7.4833,PO,99,30,177,21,81,111,169,190
9358,51.4667,7.3667,PO,99,29,201,32,83,112,185,217
9363,51.4189,7.425,PO,96,24,172,28,85,109,155,183
9366,51.3667,7.25,PO,111,10,209,4,105,115,207,211
9369,51.4167,7.1167,PO,104,11,183,10,101,112,179,189
9375,51.5333,7.6833,PO,110,8,194,7,106,114,190,197
9376,51.6,7.7667,PO,105,20,196,14,95,115,187,201
9379,51.5833,7.8833,PO,107,0,206,9,107,107,201,210
9381,51.6333,7.9333,PO,98,25,176,8,86,111,172,180
9382,51.65,7.8667,PO,100,19,190,12,93,112,182,194
9385,50.0852,8.7821,PO,114,15,218,0,106,121,218,218
9392,50.6167,9.1167,PO,112,6,208,18,109,115,201,219
9400,49.6667,8.55,PO,84,30,177,25,68,98,163,188
9405,49.6061,8.4541,PO,92,4,185,19,90,94,172,191
9414,50.3333,9.0667,PO,83,0,198,0,83,83,198,198
9415,50.3667,9.0333,PO,112,20,199,31,101,121,183,214
9419,50.4167,9,PO,105,36,197,18,82,118,188,206
9429,49.8,8.6,PO,76,3,177,12,75,78,171,183
9430,49.8667,8.7667,PO,89,48,176,17,59,107,171,188
9434,49.7667,8.8833,PO,122,0,200,9,122,122,196,205
9442,49.9,9.0333,PO,88,14,172,5,81,95,169,174
9460,49.7167,8.8667,PO,111,0,190,0,111,111,190,190
9466,50.2833,8.85,PO,93,41,186,22,78,119,171,193
9469,50.2333,8.7667,PO,87,26,181,29,73,99,166,195
9470,50.2333,8.8667,PO,82,0,195,0,82,82,195,195
9476,50.2667,8.7,PO,94,40,180,26,72,112,172,198
9477,50.1833,8.7333,PO,92,31,183,25,73,104,170,195
9480,50.5833,8.75,PO,113,17,194,16,105,122,190,206
9497,49.8333,8.4667,PO,86,31,178,21,67,98,166,187
9500,49.9167,8.4833,PO,74,14,173,13,65,79,168,181
9509,50.5333,9.3333,PO,120,8,225,24,117,125,213,237
9530,50.1167,8.9167,PO,109,0,207,0,109,109,207,207
9531,50.55,9.6667,PO,120,6,236,0,117,123,236,236
9534,50.8167,8.7833,PO,116,14,187,24,111,125,175,199
9540,51.2,10.0667,PO,112,0,197,0,112,112,197,197
9547,51.2167,8.9833,PO,113,13,196,21,106,119,184,205
9550,50.9833,8.7333,PO,111,0,187,0,111,111,187,187
9558,51.1667,8.9,PO,107,28,204,27,94,122,195,222
9570,50.9333,9.55,PO,117,13,198,25,109,122,184,209
9582,50.5,9.5667,PO,114,9,218,30,110,119,205,235
9583,50.5833,9.65,PO,111,28,211,4,95,123,209,213
9585,50.5833,10.0167,PO,114,6,227,12,111,117,222,234
9593,50.5667,9.7667,PO,116,9,212,24,111,120,204,228
9603,50.5333,9.65,PO,111,33,187,21,90,123,177,198
9604,50.6333,10.0167,PO,117,14,207,50,109,123,190,240
9607,50.5,10.0167,PO,118,9,244,1,114,123,244,245
9618,51.45,9.4167,PO,110,6,212,23,108,114,200,223
9621,51.4,9.4667,PO,111,4,206,18,109,113,198,216
9623,51.4333,9.4833,PO,123,2,210,3,122,124,208,211
9629,51.5,9.6,PO,104,11,183,0,98,109,183,183
9643,50.7833,9.8667,PO,104,0,204,0,104,104,204,204
9645,51.2667,9.3833,PO,95,0,181,0,95,95,181,181
9646,51.2833,9.6,PO,103,26,210,32,90,116,193,225
9648,51.3167,9.55,PO,102,48,181,27,81,129,166,193
9652,51.2667,9.4167,PO,110,5,222,19,108,113,212,231
9660,50.8833,8.7667,PO,111,7,194,13,108,115,188,201
9683,51.1333,9.4,PO,102,0,207,22,102,102,196,218
9685,51.1333,9.5333,PO,110,13,200,26,101,114,184,210
9691,51.0333,9.9,PO,112,12,225,9,108,120,221,230
9698,51.0167,9.9333,PO,118,0,244,0,118,118,244,244
9714,51.15,9.15,PO,99,17,179,13,89,106,172,185
9715,51.05,9.0667,PO,116,0,240,0,116,116,240,240
9717,51.1667,9.1333,PO,108,14,234,0,100,114,234,234
9722,51.1333,9.0167,PO,134,0,194,0,134,134,194,194
9725,51.15,9.05,PO,98,16,193,0,89,105,193,193
9726,51.2833,8.8667,PO,118,19,215,15,109,128,209,224
9732,51.4667,9.0167,PO,113,20,202,36,100,120,184,220
9734,51.25,9,PO,108,29,199,25,90,119,191,216
9737,51.3333,8.9667,PO,114,9,208,42,110,119,185,227
9764,51.45,9.25,PO,103,23,184,26,90,113,168,194
9766,51.3333,9.1667,PO,102,14,189,6,97,111,186,192
9768,51.241,9.2629,PO,115,19,214,35,109,128,197,232
9769,50.95,9.2167,PO,110,15,203,13,101,116,198,211
9776,50.8667,9.35,PO,109,15,206,21,101,116,199,220
9784,50.9167,9.25,PO,112,8,196,20,108,116,185,205
9793,50.1,8.3,PO,108,30,202,18,90,120,196,214
9832,50.2167,9.2667,PO,105,0,211,0,105,105,211,211
9833,50.15,8.75,PO,92,21,193,27,79,100,183,210
9837,50.1667,8.9833,PO,105,32,187,29,88,120,175,204
9842,50.45,8.0333,PO,101,16,183,20,94,110,175,195
9845,50.3167,8.15,PO,96,8,182,9,92,100,178,187
9846,50.3833,8.05,PO,101,38,190,38,78,116,175,213
9857,50.1,8.4,PO,104,42,182,43,80,122,160,203
9859,50.1667,8.3167,PO,110,0,197,0,110,110,197,197
9862,50.4,8.2167,PO,98,12,192,25,91,103,178,203
9867,50.2,8.5833,PO,99,38,185,21,80,118,180,201
9871,50.0333,8.0667,PO,97,20,188,30,87,107,176,206
9876,50.05,8.15,PO,116,12,189,29,110,122,172,201
9886,50.3167,9.4667,PO,111,14,228,7,104,118,225,232
9901,50.3,8.5167,PO,101,0,207,28,101,101,194,222
9913,50.5167,8.3833,PO,117,21,189,19,102,123,179,198
9921,50.55,8.35,PO,107,24,192,11,94,118,185,196
9928,50.5833,8.55,PO,111,6,206,23,108,114,193,216
9933,50.55,7.1,PO,104,26,179,31,92,118,162,193
9939,50.5,6.9333,PO,103,21,195,10,91,112,189,199
9943,50.5,7.15,PO,117,13,208,35,109,122,195,230
9945,50.6,7.1833,PO,91,30,195,30,80,110,180,210
9956,50.7167,7.9833,PO,126,0,224,19,126,126,215,234
9957,50.65,7.5333,PO,110,19,211,41,98,117,193,234
9960,50.7667,7.6667,PO,118,5,212,10,115,120,207,217
9968,49.6333,7.2833,PO,110,17,206,0,102,119,206,206
9975,49.75,7.3,PO,104,30,206,25,90,120,192,217
9986,50.3667,7.5167,PO,82,22,176,10,73,95,173,183
10001,50.4333,7.4,PO,102,24,191,14,88,112,185,199
10010,50.3,7.1667,PO,97,31,192,26,81,112,180,206
10015,50.3333,7.3167,PO,89,4,185,15,87,91,180,195
10018,50.5,7.3333,PO,114,22,184,3,103,125,182,185
10031,50.1667,7.55,PO,99,20,192,17,88,108,185,202
10035,49.8667,7.5167,PO,107,26,211,14,90,116,204,218
10039,50.0833,7.4333,PO,117,0,231,2,117,117,230,232
10051,49.85,7.1167,PO,114,0,204,18,114,114,195,213
10063,49.7333,7,PO,120,0,215,0,120,120,215,215
10068,50.0167,6.2833,PO,128,11,196,9,123,134,192,201
10074,49.9667,6.4167,PO,108,28,202,31,94,122,189,220
10084,50.3,6.7,PO,118,7,222,43,114,121,198,241
10091,50.2833,6.6333,PO,114,11,204,30,107,118,188,218
10093,50.2,6.4167,PO,107,30,224,35,90,120,210,245
10096,50.0833,6.2667,PO,101,15,240,18,95,110,232,250
10100,50.2333,6.4667,PO,118,12,227,9,111,123,221,230
10102,50.35,6.4167,PO,126,0,239,0,126,126,239,239
10107,49.6833,6.55,PO,111,38,194,44,85,123,176,220
10108,49.7,6.5833,PO,119,3,212,12,117,120,206,218
10114,49.85,6.6333,PO,116,35,214,24,92,127,199,223
10122,49.8,6.7167,PO,114,0,200,6,114,114,197,203
10125,49.7333,6.6833,PO,94,17,183,15,87,104,175,190
10130,49.9833,6.8833,PO,116,15,191,21,108,123,183,204
10132,49.9667,6.7,PO,101,25,220,48,89,114,198,246
10133,49.9833,6.7667,PO,115,17,206,24,106,123,196,220
10139,50.6667,7.8167,PO,107,35,197,17,89,124,190,207
10140,50.5167,7.9167,PO,112,0,209,0,112,112,209,209
10141,50.6833,7.75,PO,111,0,178,0,111,111,178,178
10147,50.5667,7.9667,PO,102,23,197,18,89,112,189,207
10148,50.2333,7.8667,PO,112,17,204,17,106,123,192,209
10149,50.1333,7.75,PO,96,16,182,46,88,104,167,213
10153,50.2,7.8667,PO,110,18,202,17,104,122,195,212
10155,50.3,7.6,PO,111,22,196,10,100,122,191,201
10160,50.3,7.8,PO,108,10,191,33,103,113,174,207
10167,50.5667,7.8333,PO,104,23,198,20,89,112,190,210
10172,50.4833,7.7667,PO,117,2,190,8,116,118,186,194
10176,49.6333,8.3667,PO,75,19,170,12,67,86,165,177
10182,49.7833,8.2,PO,111,15,191,19,101,116,181,200
10190,49.8667,8,PO,110,5,183,0,108,113,183,183
10192,49.9667,8.2,PO,98,0,181,0,98,98,181,181
10196,49.85,8.35,PO,106,9,184,12,101,110,178,190
10199,49.6667,8.2333,PO,92,9,174,2,87,96,173,175
10213,49.1,8,PO,94,0,180,0,94,94,180,180
10215,49.1667,7.8833,PO,107,13,188,3,101,114,187,190
10218,49.5833,8.1667,PO,74,0,163,26,74,74,146,172
10220,49.5667,8.25,PO,72,30,163,24,55,85,151,175
10236,49.4667,7.5667,PO,112,17,225,7,108,125,220,227
10242,49.65,8.1,PO,108,0,200,5,108,108,198,203
10253,49.4,7.4333,PO,111,19,232,0,101,120,232,232
10261,49.2667,8.2167,PO,97,0,178,0,97,97,178,178
10267,49.3833,8.3,PO,78,5,180,1,76,81,179,180
10268,49.4571,8.2892,PO,85,7,179,22,81,88,170,192
10269,49.4167,8.4,PO,74,16,160,20,66,82,149,169
10270,49.4667,8.1333,PO,93,19,183,20,80,99,175,195
10272,49.4167,8.1833,PO,88,26,192,0,72,98,192,192
10274,49.3,8.2333,PO,80,39,182,6,61,100,179,185
10279,49.4,8.2,PO,86,22,178,22,74,96,164,186
10285,49.2167,7.5667,PO,116,0,201,0,116,116,201,201
10288,49.2939,7.6128,PO,116,14,209,17,110,124,202,219
10299,49.6333,7.9,PO,106,63,195,16,65,128,186,202
10303,49.3,8.35,PO,83,24,171,32,73,97,155,187
10311,49.2833,7.4333,PO,110,7,198,6,106,113,194,200
10313,49.2167,7.3667,PO,98,46,207,45,70,116,175,220
10331,48.8833,9.9667,PO,110,6,208,35,108,114,190,225
10338,48.9333,9.3667,PO,97,28,194,18,78,106,186,204
10349,48.5167,8.8333,PO,97,26,195,30,90,116,180,210
10350,48.6,8.8667,PO,98,12,183,1,92,104,183,184
10358,49.1833,10.15,PO,116,29,240,4,98,127,238,242
10372,48.7167,9.4167,PO,116,10,192,0,112,122,192,192
10373,48.7244,9.2468,PO,97,31,186,32,78,109,169,201
10403,49.0833,9.1,PO,86,28,175,12,71,99,171,183
10406,49.0833,9.15,PO,80,31,174,11,66,97,169,180
10416,49.3833,9.7,PO,81,0,195,32,81,81,177,209
10421,48.8167,8.8667,PO,99,36,185,38,80,116,164,202
10424,48.8,9.0167,PO,84,1,188,15,84,85,179,194
10427,48.7667,8.9333,PO,102,34,196,30,83,117,183,213
10430,49,9.1333,PO,82,34,179,29,60,94,160,189
10437,48.9,9.1833,PO,85,30,178,8,67,97,174,182
10439,48.9,9.0833,PO,81,30,180,24,65,95,172,196
10442,49.5167,9.75,PO,106,26,203,23,90,116,192,215
10465,49.2833,9.5667,PO,104,3,195,0,103,106,195,195
10470,49.15,9.6167,PO,114,0,229,0,114,114,229,229
10474,48.8,9.9333,PO,111,2,240,0,110,112,240,240
10478,48.7833,9.8,PO,114,6,188,10,110,116,182,192
10482,49.0833,9.5667,PO,115,0,240,0,115,115,240,240
10511,48.8833,9.35,PO,82,11,195,0,76,87,195,195
10512,48.8333,9.3167,PO,96,24,176,15,82,106,171,186
10525,49.1333,8.5833,PO,107,13,198,18,99,112,191,209
10526,49.1,8.65,PO,114,8,202,24,110,118,190,214
10532,49.1833,8.75,PO,102,14,182,8,96,110,178,186
10536,49.2167,8.5167,PO,91,10,183,7,86,96,180,187
10537,49.1833,8.6833,PO,88,31,184,20,67,98,174,194
10542,49.5333,9.3167,PO,104,9,195,9,101,110,190,199
10561,49.3833,8.8,PO,87,21,166,0,80,101,166,166
10563,49.25,8.7,PO,107,0,168,0,107,107,168,168
10564,49.2667,8.75,PO,119,12,208,30,114,126,191,221
10565,49.3833,8.8833,PO,104,26,185,23,90,116,172,195
10568,49.0667,8.4667,PO,92,18,179,26,81,99,169,195
10576,49.0167,8.5,PO,101,15,184,41,93,108,160,201
10577,49.1167,8.4167,PO,84,20,169,19,76,96,159,178
10578,48.9667,8.3,PO,110,10,204,3,106,116,203,206
10579,48.95,8.5333,PO,112,4,193,0,110,114,193,193
10580,48.9833,8.5333,PO,95,41,193,27,71,112,177,204
10581,49.05,8.5333,PO,126,0,209,0,126,126,209,209
10582,49.0167,8.6,PO,102,3,207,6,101,104,204,210
10585,49.6,8.65,PO,85,24,181,0,73,97,181,181
10587,49.4667,8.6167,PO,102,17,188,36,93,110,172,208
10592,49.3833,8.5667,PO,93,47,185,64,69,116,148,212
10614,49.1833,8.8167,PO,87,21,161,7,74,95,159,166
10621,49.2167,9,PO,111,18,181,0,102,120,181,181
10623,49.2333,8.7833,PO,97,0,205,0,97,97,205,205
10628,49.2167,8.9167,PO,108,0,195,0,108,108,195,195
10629,49.25,8.8833,PO,116,1,200,13,116,117,194,207
10631,49.1,8.85,PO,109,35,197,50,87,122,175,225
10634,49.75,9.3167,PO,100,15,183,21,91,106,175,196
10647,47.9833,7.9,PO,96,0,201,0,96,96,201,201
10651,48.7,8.1333,PO,101,30,198,20,86,116,190,210
10652,48.7167,8.1667,PO,95,42,192,20,76,118,181,201
10658,47.9,8.4333,PO,111,0,228,16,111,111,220,236
10667,48.1333,7.7333,PO,95,10,182,21,90,100,175,196
10672,48.1333,7.7,PO,84,56,182,26,55,111,173,199
10679,48.1667,7.65,PO,100,32,184,16,88,120,176,192
10683,48.0167,7.6833,PO,78,37,159,32,55,92,145,177
10705,47.7667,8.8333,PO,94,0,194,0,94,94,194,194
10708,48.3333,7.8833,PO,105,37,186,19,83,120,181,200
10709,48.2833,7.8167,PO,95,12,175,10,89,101,170,180
10723,47.65,7.8333,PO,108,0,190,9,108,108,185,194
10725,47.6,7.6333,PO,82,28,176,19,66,94,166,185
10728,47.7167,7.55,PO,108,0,180,16,108,108,172,188
10729,47.8667,7.6,PO,72,27,159,30,54,81,141,171
10750,48.5167,8.1167,PO,106,7,212,20,103,110,200,220
10751,48.5333,8.0833,PO,98,23,176,7,83,106,172,179
10753,48.4833,8.1667,PO,107,19,206,14,101,120,198,212
10789,47.7667,9.1667,PO,105,39,214,32,77,116,198,230
10796,48.0667,8.4667,PO,109,0,235,20,109,109,223,243
10804,47.6167,8.3167,PO,103,47,188,41,76,123,167,208
10824,48.2,9.7667,PO,111,22,200,16,104,126,192,208
10826,48.0667,9.95,PO,111,18,207,47,100,118,185,232
10827,48.2167,9.95,PO,113,12,225,0,108,120,225,225
10836,48.65,8.7833,PO,106,24,192,36,92,116,179,215
10848,48.2833,9.7167,PO,113,10,200,12,109,119,193,205
10859,48.4167,8.4667,PO,121,2,244,0,120,122,244,244
10860,48.5333,8.5667,PO,114,27,245,0,98,125,245,245
10865,48.3167,9.0667,PO,110,0,209,50,110,110,183,233
10869,48.45,8.6833,PO,110,10,216,43,106,116,196,239
10887,47.9333,9.75,PO,109,13,192,20,102,115,180,200
10891,48.4,9.2,PO,119,11,222,2,115,126,221,223
10894,48.5333,9.2,PO,97,21,202,1,83,104,202,203
10903,48.1667,8.6333,PO,114,19,222,31,103,122,211,242
10906,47.9333,9.55,PO,111,14,211,12,102,116,205,217
10919,48.0667,9.1833,PO,108,4,209,13,106,110,201,214
10920,48.0167,9.25,PO,113,24,211,25,102,126,200,225
10925,48.1833,9.2167,PO,112,16,207,17,106,122,199,216
10935,48.4667,8.9333,PO,98,31,194,51,78,109,164,215
10942,47.9835,8.8358,PO,101,9,216,34,98,107,198,232
10951,47.7333,12.8833,PO,89,18,200,26,80,98,190,216
10952,48.4,11.75,PO,109,11,198,12,103,114,192,204
10968,48.5833,11.0833,PO,91,21,184,27,79,100,170,197
10969,48.4,11.2,PO,97,35,189,42,74,109,161,203
10970,48.2333,12.6833,PO,105,8,189,17,101,109,181,198
10976,48.2667,12.65,PO,103,15,182,7,98,113,179,186
10983,47.85,12.0667,PO,87,32,191,28,76,108,180,208
11000,48.1667,12,PO,106,0,205,6,106,106,202,208
11002,48.2,11.8667,PO,105,0,216,0,105,105,216,216
11009,48.3167,11.9167,PO,94,35,186,36,71,106,168,204
11024,47.6,11.1833,PO,118,7,177,0,115,122,177,177
11027,47.5,11.2833,PO,120,0,239,0,120,120,239,239
11030,48.8167,11.4667,PO,91,25,188,28,79,104,174,202
11049,47.9333,12.9333,PO,114,4,199,11,112,116,192,203
11081,48.6833,11.6167,PO,101,27,206,29,87,114,185,214
11088,47.75,12.1167,PO,110,18,197,21,103,121,186,207
11095,47.7333,10.7833,PO,96,9,212,3,91,100,210,213
11096,47.85,10.9,PO,127,4,187,12,125,129,181,193
11101,48.6333,11.3167,PO,88,22,184,13,75,97,177,190
11104,48.55,11.3,PO,89,32,184,47,72,104,164,211
11118,47.9,12.5833,PO,118,18,195,16,109,127,187,203
11121,47.85,12.5667,PO,114,0,214,6,114,114,211,217
11154,47.8833,11.0333,PO,113,0,200,11,113,113,195,206
11159,47.9667,11.65,PO,106,0,195,0,106,106,195,195
11163,48.8833,12.6,PO,85,32,170,5,68,100,168,173
11173,48.7833,12.8667,PO,94,25,180,20,78,103,170,190
11174,48.8167,12.8,PO,94,30,183,30,78,108,166,196
11179,48.4167,12.7667,PO,104,32,169,0,87,119,169,169
11191,48.8667,13.4667,PO,118,13,213,34,113,126,192,226
11193,48.85,13.3333,PO,115,14,201,36,106,120,179,215
11199,48.4167,13.2167,PO,113,15,209,0,106,121,209,209
11207,48.8167,11.85,PO,104,25,193,18,92,117,186,204
11210,48.75,11.85,PO,107,5,191,6,104,109,188,194
11214,49.1333,12.7333,PO,113,2,214,8,112,114,210,218
11219,48.7333,12.75,PO,106,6,170,6,103,109,167,173
11228,48.7333,12.3,PO,97,36,172,33,78,114,152,185
11232,48.7333,12.25,PO,104,9,191,34,99,108,176,210
11249,48.4,13,PO,97,0,186,0,97,97,186,186
11257,48.8167,12.05,PO,111,37,194,44,96,133,172,216
11263,48.9167,12.6,PO,98,19,178,0,88,107,178,178
11268,48.3833,12.3167,PO,120,9,199,23,115,124,188,211
11294,48.7833,13.45,PO,102,0,200,0,102,102,200,200
11295,48.75,13.5167,PO,115,4,201,4,113,117,199,203
11305,49.3333,12.1167,PO,105,23,189,22,90,113,179,201
11309,49.5333,11.8,PO,115,30,204,17,96,126,195,212
11314,49.6,11.75,PO,113,14,210,19,108,122,203,222
11321,49.1167,11.45,PO,109,21,196,12,97,118,190,202
11325,49.2,12.0333,PO,100,0,197,10,100,100,192,202
11333,49.3167,12.85,PO,124,0,212,0,124,124,212,212
11334,49.2167,12.7667,PO,101,23,192,27,90,113,179,206
11345,49.95,12.0333,PO,115,23,226,36,103,126,210,246
11352,49.1667,11.45,PO,90,9,187,2,85,94,186,188
11365,49.7667,12.1,PO,109,23,197,22,94,117,188,210
11374,49.4833,12.3833,PO,115,7,193,0,112,119,193,193
11377,49.1,11.8167,PO,110,6,208,19,108,114,200,219
11379,49.0333,11.9,PO,108,9,178,16,104,113,169,185
11384,49.2167,11.7667,PO,116,9,205,17,112,121,199,216
11385,49.0667,11.8833,PO,124,4,210,0,123,127,210,210
11387,49.1667,11.7167,PO,92,11,189,24,85,96,176,200
11388,49.1167,11.7333,PO,103,35,203,27,79,114,192,219
11400,49.0667,12.0167,PO,91,28,177,11,76,104,170,181
11403,48.9167,12.4333,PO,71,0,172,0,71,71,172,172
11405,49.0333,12.25,PO,111,10,192,45,105,115,173,218
11407,49.15,12.2833,PO,108,8,208,26,103,111,190,216
11415,49.2167,12.5167,PO,110,18,204,14,98,116,198,212
11416,49.2,12.2667,PO,117,0,207,27,117,117,190,217
11417,49.2667,12.5333,PO,118,6,209,8,115,121,204,212
11426,49.4167,11.65,PO,116,9,218,24,111,120,208,232
11433,49.7833,12.3167,PO,116,12,200,5,110,122,198,203
11447,49.65,12.2667,PO,110,0,221,0,110,110,221,221
11448,49.55,12.4167,PO,113,18,226,30,104,122,211,241
11449,49.6167,12.35,PO,114,3,228,43,113,116,213,256
11452,49.4333,12.5833,PO,116,11,223,32,111,122,211,243
11454,49.95,11.5667,PO,100,15,188,6,91,106,185,191
11456,50.2667,10.9667,PO,103,23,198,36,90,113,182,218
11459,50,12.0833,PO,110,6,237,6,107,113,234,240
11466,49.9333,10.85,PO,90,23,173,7,78,101,170,177
11477,49.7833,10.7,PO,115,0,202,1,115,115,202,203
11479,49.8667,11,PO,104,7,199,0,99,106,199,199
11482,49.9667,11,PO,100,10,185,17,96,106,174,191
11486,49.9333,11.6167,PO,104,35,203,28,87,122,187,215
11487,50.05,11.6667,PO,119,17,215,0,110,127,215,215
11494,50,11.6833,PO,110,7,207,43,108,115,190,233
11508,50.2667,11.15,PO,112,14,203,29,106,120,192,221
11509,50.2167,11.1333,PO,113,12,201,28,108,120,190,218
11510,50.3333,11.1,PO,109,17,200,30,103,120,186,216
11515,49.7833,11.1833,PO,96,35,183,23,82,117,172,195
11526,49.6333,10.95,PO,103,22,190,20,89,111,180,200
11530,49.75,10.7167,PO,104,0,204,24,104,104,193,217
11562,50.1333,11.25,PO,107,10,214,22,102,112,206,228
11570,50.0667,11.2667,PO,109,11,202,10,104,115,198,208
11571,50.1167,11.15,PO,116,21,204,25,105,126,192,217
11586,50.3167,11.75,PO,115,18,218,24,104,122,202,226
11590,49.7667,11.35,PO,112,22,184,10,101,123,179,189
11591,49.85,11.6,PO,112,8,200,15,108,116,192,207
11599,50.2,12.0833,PO,114,3,202,12,113,116,196,208
11600,50.1833,12.0833,PO,118,7,220,15,115,122,213,228
11609,50.0333,11,PO,114,0,209,0,114,114,209,209
11622,49.3,10.5833,PO,106,20,195,20,95,115,185,205
11631,49.2833,10.8667,PO,120,0,194,0,120,120,194,194
11634,49.3333,10.8,PO,110,7,204,12,107,114,198,210
11645,49.0333,10.6,PO,100,16,201,35,90,106,183,218
11648,48.9167,11.35,PO,97,11,183,9,91,102,179,188
11652,49.5833,11.2,PO,112,10,207,22,108,118,193,215
11655,49.5667,11.1833,PO,100,21,192,27,87,108,184,211
11656,49.55,10.95,PO,100,24,217,4,84,108,215,219
11670,49.5,10.8833,PO,106,19,188,23,95,114,177,200
11675,49.5167,11.4167,PO,114,1,205,20,113,114,195,215
11679,49.25,11.2333,PO,91,0,207,0,91,91,207,207
11689,49.0833,11.2167,PO,114,3,202,2,113,116,201,203
11696,49.4833,10.7167,PO,108,12,210,11,100,112,203,214
11702,49.4,11.4,PO,110,3,202,22,108,111,192,214
11704,49.2833,10.2667,PO,105,14,206,9,99,113,202,211
11709,49.6833,10.3,PO,91,0,200,0,91,91,200,200
11716,49.25,11.0833,PO,118,3,202,3,116,119,201,204
11720,49.6333,10.2333,PO,94,11,198,19,89,100,191,210
11733,48.9,11,PO,112,4,194,1,110,114,193,194
11742,50.05,9.3167,PO,119,2,202,17,118,120,195,212
11747,49.9333,9.0833,PO,113,4,208,14,112,116,203,217
11750,50,9.2,PO,105,47,197,13,73,120,193,206
11760,50.25,10.2,PO,115,13,216,29,107,120,201,230
11767,50.1667,10.1667,PO,104,26,195,14,91,117,188,202
11769,50.3167,10.2167,PO,110,13,218,29,105,118,204,233
11776,50.2833,9.7,PO,110,0,202,0,110,110,202,202
11780,50.2833,9.9167,PO,108,1,212,9,107,108,208,217
11794,50.2,9.6167,PO,114,12,217,21,108,120,205,226
11796,50.1,9.65,PO,114,6,208,14,111,117,204,218
11798,50.1,9.8,PO,106,29,187,23,90,119,178,201
11823,49.95,10.6,PO,112,14,216,57,108,122,185,242
11825,49.9667,10.5667,PO,104,8,227,0,100,108,227,227
11841,50.0167,9.8833,PO,109,15,188,3,101,116,187,190
11845,49.9,9.8167,PO,101,32,192,31,90,122,177,208
11849,49.7167,10.2167,PO,112,7,203,12,109,116,198,210
11853,49.8667,10.1333,PO,85,36,186,28,65,101,173,201
11854,49.85,10.1,PO,98,21,181,15,87,108,175,190
11856,50.3,10.5667,PO,115,19,226,7,103,122,223,230
11860,50.3333,10.35,PO,113,24,196,24,96,120,184,208
11862,50.0667,9.65,PO,116,10,190,8,112,122,186,194
11873,50.4,10.2,PO,105,16,192,11,100,116,186,197
11886,49.7,9.25,PO,99,7,190,20,95,102,182,202
11890,49.8333,9.1333,PO,79,27,187,12,68,95,180,192
11897,49.7,10.0167,PO,95,23,175,7,82,105,172,179
11898,50,10.1833,PO,91,11,182,10,87,98,177,187
11916,49.8333,9.8667,PO,109,10,206,9,105,115,200,209
11918,48.5833,10.5,PO,111,6,220,9,108,114,215,224
11923,48.7333,11.1833,PO,99,30,202,19,81,111,195,214
11927,48.4333,10.8833,PO,102,8,184,10,98,106,180,190
11937,48.6,10.5167,PO,104,0,207,0,104,104,207,207
11944,48.8333,10.85,PO,102,3,197,0,101,104,197,197
11948,48.4167,10.9667,PO,89,24,172,31,73,97,159,190
11950,48.35,10.9833,PO,87,33,185,45,69,102,172,217
11957,48.4333,10.4167,PO,105,28,211,6,88,116,207,213
11959,48.3833,10.5,PO,110,0,210,6,110,110,207,213
11960,48.3667,10.3,PO,91,24,182,29,75,99,169,198
11963,48.4833,10.3667,PO,95,50,193,37,64,114,170,207
11965,48.15,10.25,PO,117,0,197,20,117,117,185,205
11990,48.25,10.3667,PO,108,4,203,4,106,110,201,205
12001,47.9667,10.15,PO,110,18,194,44,102,120,176,220
12004,47.8667,10.2167,PO,131,8,203,0,127,135,203,203
12005,48.0667,10.2833,PO,108,1,217,24,107,108,205,229
12014,48.0667,10.65,PO,111,17,209,20,103,120,200,220
12023,48.3333,10.0667,PO,98,18,207,16,87,105,197,213
12025,48.3,10.15,PO,101,16,190,8,90,106,186,194
12030,48.8167,10.65,PO,103,5,188,3,101,106,186,189
12031,48.7833,10.5333,PO,114,0,210,0,114,114,210,210
12035,48.2667,10.8333,PO,98,28,207,25,80,108,195,220
12036,48.1667,10.8333,PO,99,27,194,38,83,110,180,218
12056,48.5833,10.75,PO,96,25,189,20,82,107,177,197
12063,49.2833,7.2167,PO,100,0,220,0,100,100,220,220
12065,49.1667,7.3167,PO,97,20,188,17,87,107,181,198
12067,49.4167,6.7667,PO,97,38,186,26,78,116,178,204
12069,49.4667,6.7,PO,93,6,224,0,90,96,224,224
12074,49.5333,6.3833,PO,108,0,182,3,108,108,181,184
12077,49.4833,6.8667,PO,109,12,206,21,104,116,198,219
12085,49.4333,6.9667,PO,89,6,188,9,85,91,183,192
12086,49.3833,7.0333,PO,120,0,214,40,120,120,194,234
12090,49.2833,6.8667,PO,97,21,199,53,89,110,171,224
12092,49.2,7.0333,PO,112,33,214,10,90,123,209,219
12094,49.1667,7.05,PO,110,12,191,10,105,117,186,196
12099,49.3167,6.8167,PO,94,13,180,19,87,100,173,192
12102,49.25,6.7,PO,94,8,189,9,90,98,184,193
12103,49.4167,6.9167,PO,111,39,192,32,91,130,180,212
12105,49.4667,6.9,PO,107,0,197,0,107,107,197,197
12109,49.25,6.7667,PO,104,9,201,6,100,109,198,204
12114,49.15,7.2167,PO,117,15,201,18,109,124,191,209
12119,49.4667,7.1667,PO,104,0,210,0,104,104,210,210
12132,52.4477,13.2975,PO,124,3,218,0,122,125,218,218
14671,53.0333,8.6667,PO,105,4,191,32,103,107,175,207
15143,50.8167,7.75,PO,110,1,200,11,110,111,194,205
15474,49.8397,12.0471,PO,118,16,209,43,110,126,179,222
15493,48.0049,7.8482,PO,72,16,170,18,62,78,163,181
15495,50.6827,9.0353,PO,112,0,223,0,112,112,223,223
